# lines contain either a single field (human, not specified further)
# or two fields separated by tab. The first field is the word (or words)
# f: female, normally referred to by 'zij' if singular
# m: male, normally referred to by 'hij' if singular
# p: normally referred to by a plural pronoun, even if singular
't Hart	m
50 Cent	m
@Laradio	f
AOW'er
Aad	m
Aad de Mos	m
Aaf	f
Aafina	f
Aafje	f
Aafke	f
Aage	m
Aagje	f
Aalbers	m
Aalders	m
Aaliyah	f
Aalt	m
Aaltje	f
Aalto	m
Aamodt	m
Aan	m
Aang	m
Aarlenaar	m
Aarlense	f
Aaron	m
Aart	m
Aart Jan de Geus	m
Aartje	f
Aat	m
Aatje	f
Ab	m
Abacavir	m
Abasjidze	m
Abbas	m
Abd	m
Abdallah	m
Abdel	m
Abdelaziz	m
Abdelghani	m
Abdelhafid	m
Abdelkader	m
Abdelkarim	m
Abdelkrim	m
Abdellah	m
Abdeltif	m
Abdelwahab	m
Abderrahim	m
Abderrahman	m
Abderrahmane	m
Abdessalam	m
Abdi	m
Abdoel	m
Abdoellah	m
Abdou	m
Abdoul	m
Abdoulaye	m
Abdul	m
Abdulah	m
Abdulahi	m
Abdulaziz	m
Abdulkadir	m
Abdulla	m
Abdullah	m
Abdullah Öcalan	m
Abdullahi	m
Abdurrahman	m
Abe	m
Abel	m
Abi	f
Abia	m
Abida	f
Abigael	f
Abigail	f
Abis Mal	m
Abner	m
Abou	m
Abou Jahjah	m
Aboutaleb	m
Abraham	m
Abram	m
Abramovich	m
Abramovitsj	m
Absalom	m
Absorptie Voriconazol	m
Abu	m
Abu Mazen	m
Abu Musab al-Zarqawi	m
Accrase	f
Accraër	m
Achab	m
Achiel	m
Achieng	f
Achille	m
Achilles	m
Achim	m
Achmad	m
Achmed	m
Achmed Hoesseini	m
Achterberg	m
Achterhoeker	m
Achterhoekse	f
Ad	m
Ada	f
Adalbert	m
Adam	m
Adam Curry	m
Adam G	m
Adam G.	m
Adamo	m
Adams	m
Adan	m
Addaio	m
Addie	m
Addo	m
Addy	m
Adeel	m
Adel	m
Adela	f
Adelbert	m
Adele	f
Adelheid	f
Adenauer	m
Adi	m
Adil	m
Adilson	m
Adina	f
Admiral Freebee	m
Adnan	m
Adne	m
Adolf	m
Adolf Hitler	m
Adolph	m
Adolphe	m
Adolphus	m
Adri	m
Adriaan	m
Adriaan van Dis	m
Adriaanse	m
Adriaen	m
Adrian	m
Adriana	f
Adriane	f
Adrianne	f
Adriano	m
Adrianus	m
Adrie	m
Adrie Koster	m
Adrien	m
Adrienne	f
Adriënne	f
Adu	m
Advocaat	m
Adwin	m
Adèle	f
Aedifica	m
Aegidius	m
Aelvoet	f
Aeneas	m
Aernoud	m
Aernoudt	m
Aernout	m
Aernouts	m
Aert	m
Aesir	f
Aesopus	m
Afellay	m
Afghaan	m
Afghaanse	f
Afra	f
Afrikaan	m
Afrikaanse	f
Afrikaner
Agaath	f
Agamemnon	m
Agassi	m
Agata	f
Agatha	f
Agatha Christie	f
Ageas	m
Ageeth	f
Agfa HealthCare	m
Aggie	f
Agnes	f
Agneta	f
Agnetha	f
Agnieszka	f
Agnès	f
Agricola	m
Agrippina	f
Aguilera	f
Aguinaldo	m
Aharon	m
Ahmad	m
Ahmadinejad	m
Ahmed	m
Ahmed Hassan	m
Ahmed M.	m
Ahmet	m
Ahtisaari	m
Aida	f
Aidan	m
Aike	m
Aikoo	f
Aila	f
Aileen	f
Aimee	f
Aimé	m
Aimé Anthuenis	m
Aimé Desimpel	m
Aimée	f
Ainhoa	f
Aisha	f
Ait Oud	m
Aitor	m
Ajahn Mun	m
Ajay	m
Akashi	m
Akbar	m
Ake	m
Akeem	m
Akenaar	m
Akense	f
Akiko	f
Akkie	f
Akosua	f
Akpala	m
Akram	m
Aksel	m
Akshay	m
Al	m
Al Gore	m
Al Saoed	m
Al-Sadr	m
Al-Zarqawi	m
Aladdin	m
Alain	m
Alan	m
Alan Greenspan	m
Alan Hovhaness	m
Alana	f
Alana Dante	f
Alanis	f
Alarik	m
Alastair	m
Alastair Campbell	m
Alban	m
Albanees	m
Albanese	f
Alberda	m
Albers	m
Albert	m
Albert Cartier	m
Albert Einstein	m
Albert Frère	m
Albert I	m
Albert II	m
Alberta	f
Alberti	m
Albertien	f
Albertina	f
Albertine	f
Alberto	m
Alberto Contador	m
Alberts	m
Albertus	m
Albin	m
Albina	f
Albrecht	m
Albrecht Rodenbach	m
Albright	f
Alcaeus	m
Alcaraz	m
Alcibiades	m
Alda	f
Alderd	m
Aldert	m
Alderweireld	m
Aldo	m
Ale	m
Alec	m
Aleid	f
Aleida	f
Aleidus	m
Alejandra	f
Alejandro	m
Alejandro Valverde	m
Alek	m
Aleks	m
Aleksa	m
Aleksandar	m
Aleksander	m
Aleksandr	m
Aleksandra	f
Aleksej	m
Alen	m
Alesi	m
Alessandra	f
Alessandro	m
Alessandro Petacchi	m
Alessia	f
Alessio	m
Alet	f
Aletta	f
Alette	f
Alex	m
Alex Agnew	m
Alex Di Gregorio	m
Alex Ferguson	m
Alexa	f
Alexander	m
Alexander De Croo	m
Alexander Georgiev	m
Alexander de Grote	m
Alexandra	f
Alexandre	m
Alexandrijn	m
Alexandrijnse	f
Alexandros	m
Alexei	m
Alexia	f
Alexis	m
Alexius	m
Alf	m
Alfons	m
Alfons De Ridder	m
Alfonso	m
Alfred	m
Alfred Hitchcock	m
Alfred Schnittke	m
Alfred Schreuder	m
Alfred Tannenberg	m
Alfred Verwee	m
Alfredo	m
Alfrink	m
Algerijn	m
Algerijnse	f
Algierse	f
Algierser	m
Ali	m
Ali Agca	m
Ali B	m
Ali Baba	m
Ali Evren	m
Alia	f
Alica	f
Alice	f
Alicia	f
Alida	f
Alina	f
Alinda	f
Aline	f
Alisa	f
Alison	f
Alistair	m
Aliya	f
Alize	f
Alje	m
Alkan	m
Alken-Maes	m
Alkimus	m
Allaah	m
Allaert	m
Allah	m
Allan	m
Allard	m
Allatta	m
Allen	m
Allenby	m
Allende	m
Allerd	m
Alles	m
Allessandro	m
Allie	m
Allison	f
Allou	m
Alma	f
Almar	m
Almaz	f
Almeerder	m
Almeerse	f
Almer	m
Almodóvar	m
Alois	m
Alois Hitler	m
Alon	m
Alona	f
Alonso	m
Alonzo	m
Aloys	m
Aloysius	m
Aloïs	m
Alparslan	m
Alpay	m
Alpha	m
Alphons	m
Alphonse	m
Alphonse Vermote	m
Alphonsus	m
Altman	m
Alun Hoddinott	m
Alva	m
Alvar	m
Alvaro	m
Alvin	m
Alwin	m
Alyattes II	m
Alyson	f
Alyssa	f
Alén	m
Amadeo	m
Amadeus	m
Amadou	m
Amaka	f
Amal	f
Amalia	f
Amalie	f
Amalrik	m
Amanda	f
Amar	m
Amaryllis	f
Amato	m
Amaury	m
Amber	f
Ambiorix	m
Ambonees
Ambrose	m
Ambrosius	m
Amelander	m
Amelandse	f
Amelia	f
Amelie	f
Amerikaan	m
Amerikaans-Samoaan	m
Amerikaans-Samoaanse	f
Amerikaanse	f
Amersfoorter	m
Amersfoortse	f
Amien	m
Amilcar	m
Amin	m
Amina	f
Amine	m
Amir	m
Amit	m
Ammaniet	m
Ammanitische	f
Ammar	m
Amon	m
Amor	m
Amos	m
Amr	m
Amrozi	m
Amsterdammer	m
Amsterdamse	f
Amundsen	m
Amy	f
Amélie	f
Amélie Mauresmo	f
An	f
An Pierlé	f
An Van Rie	f
Ana	f
Ana Cajamarca	f
Anakin	m
Anand	m
Ananda	f
Anastacia	f
Anastasia	f
Anatolische	f
Anatoliër	m
Anatoly	m
Anatool	m
Anaïs	f
Anca	f
Ancelotti	m
Anciaux	m
Andalusische	f
Andalusiër	m
Andaz	m
Anders	m
Anders Koppel	m
Andersen	m
Anderson	m
Andersson	m
Andi	m
Andijn	m
Andijnse	f
Ando	m
Andor	m
Andorraan	m
Andorraanse	f
Andras	m
Andre	m
Andre Agassi	m
Andrea	f
Andreas	m
Andree	m
Andrei	m
Andrej	m
Andres	m
Andrew	m
Andrew Lloyd Webber	m
Andrews	m
Andries	m
Andriessen	m
Andrine	f
Andriëtte	f
Andronic Demuynck	m
András	m
Andrè	m
Andrès	m
André	m
André Deruyver	m
André Greipel	m
André Hazes	m
André Ooijer	m
André Rieu	m
Andréa	f
Andrée	f
Andrés	m
Andy	m
Andy Cappelle	m
Andy Roddick	m
Andy Warhol	m
Anemoon	f
Anet	f
Aneta	f
Anette	f
Angantyr	m
Ange	f
Angela	f
Angela Merkel	f
Angelica	f
Angelie	f
Angelien	f
Angelika	f
Angelina	f
Angelina Jolie	f
Angeline	f
Angelique	f
Angelo	m
Angelos	m
Angenent	m
Angie	f
Angle	m
Angolees	m
Angolese	f
Anguillaan	m
Anguillaanse	f
Angus	m
Angy	f
Angèle	f
Angélique	f
Ani	f
Ania	f
Anil	m
Anique	f
Anis	m
Anish	m
Anisha	f
Anita	f
Anja	f
Anjali	f
Anjanie	f
Anjelica	f
Anjo	m
Ank	f
Anka	f
Ankarioot	m
Ankariotische	f
Anke	f
Anke De Mondt	f
Anker	m
Ankie	f
Anko	m
Anky	f
Anky van Grunsven	f
Ann	f
Ann Demeulemeester	f
Ann Wauters	f
Anna	f
Anna Carla	f
Annabel	f
Annabella	f
Annabelle	f
Annamaria	f
Annamarie	f
Annan	m
Annas	m
Anne	f
Anne Frank	f
Anne Teresa De Keersmaeker	f
Anne-Marie	f
Annebeth	f
Annechien	f
Annegien	f
Annegreet	f
Annejet	f
Anneke	f
Annekee	f
Anneleen	f
Anneli	f
Annelieke	f
Annelien	f
Annelies	f
Anneloes	f
Annemans	m
Annemarie	f
Annemie	f
Annemiek	f
Annemieke	f
Annemoon	f
Anner	m
Annerieke	f
Annet	f
Annetje	f
Annette	f
Anni	f
Anni Friesinger	f
Annick	f
Annie	f
Anniek	f
Annieke	f
Annika	f
Anniko	f
Anno	m
Annuska	f
Anny	f
Anny De Maght	f
Anouar	m
Anouk	f
Anouschka	f
Anousha	f
Anoushka	f
Anousjka	f
Anouska	f
Ans	f
Anselm	m
Anselmo	m
Anselmus	m
Ansgar	m
Ansje	f
Anske	m
Anson	m
Antal	m
Antar	m
Anthierens	m
Anthon	m
Anthoni	m
Anthonie	m
Anthonij	m
Anthonis	m
Anthonius	m
Anthony	m
Anthony Godett	m
Anthony Vanden Borre	m
Anthonya	f
Anthoon	m
Anthuenis	m
Antilliaan	m
Antilliaanse	f
Antiochus	m
Antipater	m
Antje	f
Antjie Krog	f
Antoin	m
Antoine	m
Antoinet	f
Antoinette	f
Anton	m
Anton Geesink	m
Antonella	f
Antonette	f
Antoni	m
Antonia	f
Antonie	m
Antonietta	f
Antonin	m
Antonina	f
Antonino	m
Antonio	m
Antonis	m
Antonius	m
Antony	m
Antoon	m
Antwerpenaar	m
Antwerpse	f
António	m
Anuschka	f
Anwar	m
Anya	f
Apeldoornse	f
Apeldorenaar	m
Aphrodite	f
Apollon	m
Apollonia	f
Apollonius	m
Apostolos	m
Apotheker	m
Appel	m
Appels	m
Appiah	m
Appie	m
Apple Computer	m
April	f
Apulische	f
Apuliër	m
Aquaman	m
Aquila	m
Aquino	m
Aquitaan	m
Aquitaanse	f
Aquiuss	m
Arabella	f
Arabier	m
Arabische	f
Arafat	m
Aragones	m
Aragorn	m
Araki	m
Aram	m
Aranka	f
Arantxa	f
Arbus	f
Arcadie	f
Arcadiër	m
Archelaüs	m
Archer	m
Archibald	m
Archie	m
Archimedes	m
Arco	m
Ard	m
Ard Schenk	m
Arda	m
Ardi	m
Ardiç	m
Aren	m
Arend	m
Arenda	f
Arendo	m
Arent	m
Aretas	m
Aretha	f
Argenta	m
Argentijn	m
Argentijnse	f
Ari	m
Ariane	f
Arianne	f
Arie	m
Ariel Sharon	m
Arielle	f
Arien	m
Ariena	f
Arif	m
Arijan	m
Arijs	m
Arik	m
Arinso	m
Aris	m
Aristide	m
Aristides	m
Aristoteles	m
Arita	f
Ariël Jacobs	m
Ariëlla	f
Ariër
Arja	f
Arjaan	m
Arjan	m
Arjan Erkel	m
Arjanne	f
Arjen	m
Arjen Robben	m
Arjenne	f
Arjo	m
Arjon	m
Arjuna	m
Arkan	m
Arko	m
Arlen	m
Arlene	f
Arlette
Arlène	f
Arman	m
Armand	m
Armando	m
Armeense	f
Armel	m
Armeniër	m
Armin	m
Arnaldo	m
Arnall	m
Arnaud	m
Arnd	m
Arne	m
Arnhemmer	m
Arnhemse	f
Arnie	m
Arno	m
Arnold	m
Arnold Bruggink	m
Arnold Schwarzenegger	m
Arnold Schönberg	m
Arnolda	f
Arnoldine	f
Arnoldus	m
Arnolfini	m
Arnon	m
Arnoud	m
Arnout	m
Arnulf	m
Aron	m
Arp	m
Arron	m
Arsen	m
Arsene Wenger	m
Arsène	m
Art	m
Artabanus	m
Artan	m
Artemis	f
Artexis	m
Arthur	m
Arthur Numan	m
Artie
Arto	m
Artur	m
Arturo	m
Artus Quellinus	m
Arubaan	m
Arubaanse	f
Aruna
Aruna Dindane	m
Arvid	m
Arvind	m
Arwen	f
Arwin	m
Ary	m
Aryan	m
Asa	m
Asad	m
Asaf	m
Aschwin	m
Ash	m
Ashanti	f
Ashcroft	m
Asher	m
Ashikaga Takauji	m
Ashley	f
Ashraf Sekkaki	m
Ashutosh	m
Asif	m
Asim	m
Aslan	m
Asma	f
Aspe	m
Assad	m
Assenaar	m
Assense	f
Asta	f
Asterix	m
Astrid	f
Asturias	m
Asuncionees	m
Asuncionese	f
Ata	m
Atahualpa	m
Atal	m
Atalja	f
Atatürk	m
Ate	m
Athanarik	m
Athanasios	m
Athanasius	m
Atheense	f
Athena	f
Athener	m
Atie	f
Atilla	m
Atirsagne	m
Atje	f
Atjeese	f
Atjeeër	m
Atkinson	f
Atomix	m
Atsma	m
Atta	m
Atte	m
Attila	m
Attilio	m
Attische	f
Attiër	m
Atze	m
Aubrey	f
Audrey	f
Audrey Hepburn	f
Audrie	f
Audry	f
August	m
Augusta	f
Auguste	f
Augustin	m
Augustine	f
Augustinus	m
Augusto	m
Augustus	m
Auke	m
Aukje	f
Aulas	m
Aulus	m
Aung San Suu Kyi	f
Aurelianus	m
Aurelio	m
Aurelius	m
Aurgelmir	m
Aurora	f
Aus der Fünten	m
Ausems	m
Auster	m
Austin	m
Australische	f
Australiër	m
Avi	m
Avril	f
Avvakoem	m
Awesome	m
Axel	m
Axel Merckx	m
Axel Witsel	m
Axelle	f
Axl Rose	m
Aya	f
Ayaan	f
Ayaan Hirsi Ali	f
Ayala
Ayda	f
Ayed Sahadi	m
Ayesha	f
Ayfer	f
Ayhan	m
Ayman	m
Aynur	f
Ayrton	m
Ayrton Senna	m
Ayse	f
Aysel	f
Ayub	m
Azarja	m
Azedine	m
Azerbeidzjaan	m
Azerbeidzjaanse	f
Azeri	m
Aziaat	m
Aziatische	f
Azing	m
Aziz	m
Aziza	f
Aznar	m
Azoriaan	m
Azoriaanse	f
Azou	m
Azteek
Aäron	m
Aïcha	f
Aïsha	f
B. en W.	p
BDW	m
BOM	f
Ba	m
Baader	m
Baal	m
Baan	m
Baantjer	m
Baar	m
Baart	m
Babel	m
Babette	f
Babs	f
Baccouche	m
Bach	m
Bacob	m
Bacon	m
Baden Cooke	m
Baden-Powell	m
Badr	m
Baert	m
Baes	m
Baeten	m
Baetens	m
Baeyens	m
Bagdadder	m
Bagdadse	f
Bagdonas	m
Baggio	m
Baguet	m
Bahamaan	m
Bahamaanse	f
Bahar	f
Bahreiner	m
Bahreinse	f
Bahá'u'lláh	m
Bail Organa	m
Bailey	m
Bailly	m
Bain	m
Baker	m
Bakke	m
Bakker	m
Bakoese	f
Bakoeër	m
Balaban	m
Balak	m
Balcaen	m
Baldewijns	m
Baldwin	m
Balinees	m
Balinese	f
Balkanees	m
Balkanese	f
Balkenende	m
Ball	m
Ballack	m
Ballard	m
Ballerini	m
Balt	m
Balta	m
Balthasar	m
Balthazar	m
Balthazar Boma	m
Baltische	f
Balzac	m
Bam	m
Bam Bam	m
Bancé	m
Bandit	f
Bangkokker	m
Bangkokse	f
Bangoura	m
Banks	m
Baptiste Planckaert	m
Barabas	m
Barack Obama	m
Barak	m
Baran	m
Barbadaan	m
Barbadaanse	f
Barbara	f
Barbara Maveau	f
Barbara de Loor	f
Barber
Barbera	f
Barbie	f
Barbra	f
Barbra Streisand	f
Barbé	m
Barda	m
Bardach	m
Barejev	m
Barend	m
Barends	m
Baresi	m
Barman	m
Barnabas	m
Barnard	m
Barnes	m
Barney	m
Baros	m
Barrett	m
Barrichello	m
Barrie	m
Barroso	m
Barrosso	m
Barrot	m
Barry	m
Bart	m
Bart Baele	m
Bart Bonroy	m
Bart De Pauw	m
Bart De Wever	m
Bart Goor	m
Bart Moeyaert	m
Bart Peeters	m
Bart Somers	m
Bart Van den Eede	m
Bart Veldkamp	m
Bart Wellens	m
Bart de Wever	m
Bartabas	m
Bartel	m
Bartele	m
Barth	m
Barthez	m
Bartho	m
Barthold	m
Bartholdi	m
Bartholomaeus	m
Bartholomeus	m
Bartimeüs	m
Bartina	f
Bartje	m
Barto	m
Bartoli	f
Bartolomeüs	m
Bartosz	m
Baruch	m
Barât	m
Bas	m
Basa	m
Basajev	m
Baseggio	m
Baselitz	m
Basescu	m
Bashir	m
Basil	m
Basile	m
Basilius	m
Basim	m
Bask	m
Baskische	f
Bass	m
Bassam	m
Basso	m
Basten	m
Bastiaan	m
Bastian Schweinsteiger	m
Bastin	m
Bataille	m
Bates	m
Batibouw	m
Batista	m
Batu	m
Baudelaire	m
Bauer	m
Bauke	m
Baukje	f
Baum	m
Baumann	m
Bausch	f
Bauwens	m
Bavo	m
Baxter	m
Bayan	f
Bayat	m
Bayens	m
Bea	f
Beast	m
Beate	f
Beatrice	f
Beatrijs	f
Beatrix	f
Beatriz	f
Beau	m
Bebel	f
Beck	m
Beckenbauer	m
Becker	m
Beckers	m
Beckett	m
Beckham	m
Becks	m
Becky	f
Beda	m
Beeken	m
Beelen	m
Beenhakker	m
Beerens	m
Beernaert	m
Beertje	f
Beethoven	m
Begeyn	m
Beier	m
Beierse	f
Beirens	m
Beiroeter	m
Beiroetse	f
Beke	m
Bekele	m
Bel Geddes	m
Belauer	m
Belause	f
Belg	m
Belgische	f
Belgradose	f
Belgradoër	m
Belia	f
Belic	m
Belinda	f
Belizaan	m
Belizaanse	f
Bell	m
Bella	f
Bellaart	m
Bellakhdim	m
Bellamy	m
Belle Perez	f
Bellens	m
Bellewaerde	m
Bellewaerde Park	m
Bellion	m
Belliraj	m
Beloki	m
Bemba	m
Ben	m
Ben Allal	m
Ben Berden	m
Ben Crabbé	m
Ben Jelloun	m
Benali	m
Benavides	m
Bendaha	m
Bender	m
Benedict	m
Benedicta	f
Benedictus	m
Benedictus XVI	m
Benedikt	m
Benes	m
Bengaal	m
Bengaalse	f
Bengt	m
Beniamino	m
Benice	f
Benicio	m
Beniner	m
Beninse	f
Benita	f
Benito	m
Benito Mussolini	m
Benjamin	m
Benjamín	m
Benjo	m
Benk	m
Benne	m
Bennet	m
Bennett	m
Benni	m
Bennie	m
Benno	m
Benno Barnard	m
Benny	m
Benny Vansteelant	m
Benoit	m
Benoît	m
Benson	m
Bent	m
Bente	f
Benvenuto	m
Beorn	m
Bep	f
Beppie	f
Berberse	f
Berckmans	m
Berden	m
Berdien	f
Berekiah	m
Beren	f
Berend	m
Berengar	m
Berenice	f
Berezovski	m
Bergen	m
Bergenaar	m
Bergense	f
Berger	m
Berghmans	m
Berghuis	m
Bergkamp	m
Berin	f
Berings	f
Berisha	m
Berit	f
Berk
Berkhout	m
Berlage	m
Berlijner	m
Berlijnse	f
Berlioz	m
Berlusconi	m
Bernadet	f
Bernadette	f
Bernadine	f
Bernard	m
Bernard Hinault	m
Bernarda	f
Bernardine	f
Bernardo	m
Bernardus	m
Bernd	m
Bernd Thijs	m
Berner	m
Bernerin	f
Bernhard	m
Bernice	f
Bernie	m
Bernie Ecclestone	m
Bernini	m
Bernlef	m
Bernold	m
Bernt	m
Berny	m
Berrie	m
Berry	m
Berry Visser	m
Bert	m
Bert Anciaux	m
Bert van Marwijk	m
Berta	f
Bertel	m
Bertels	m
Bertha	f
Berthe	f
Berthelin	m
Berthil	m
Bertho	m
Berthold	m
Bertie	m
Bertien	f
Bertil	m
Bertina	f
Bertine	f
Bertinus	m
Bertjan	m
Bertje	f
Berto	m
Bertold	m
Bertolucci	m
Bertram	m
Bertrand	m
Bertus	m
Bervoets	m
Beryl	f
Berzin	m
Besim	m
Bess	f
Bessel	m
Best	m
Bethany	f
Betje	f
Bets	f
Betsie	f
Betske	f
Betsy	f
Bette	f
Bettens	m
Bettie	f
Bettien	f
Bettina	f
Bettine	f
Bettini	m
Betty	f
Betuwer	m
Betuwse	f
Beukenkamp	m
Beuys	m
Beverly	f
Beyens	m
Beyoncé	f
Beysen	m
Bhutaan	m
Bhutaanse	f
Bhutto	f
Biac	m
Bianca	f
Bianchi	m
Bibi	f
Bibian	f
Bibiane	f
Biden	m
Bieke	f
Bierhoff	m
Biggs	m
Biglia	m
Bijan	m
Bijl	m
Bijnens	m
Bikker	m
Bilal	m
Bileam	m
Biljana	f
Bill	m
Bill Clinton	m
Bill Gates	m
Bill Haley	m
Billal	m
Billie	f
Billy	m
Bin Laden	m
Bing	m
Binjamin	m
Binyamin	m
Bircan	f
Birger	m
Birger Leys	m
Birgit	f
Birgitta	f
Birmees	m
Birmese	f
Bishop	m
Bismarck	m
Bissauer	m
Bissause	f
Bistro Novo	m
Bix	m
Bjarne	m
Bjarne Riis	m
Bjoerndalen	m
Bjorn	m
Björk	f
Björn	m
Björn Sengier	m
Bjørn	m
Bjørndalen	m
Black	m
Black Bolt	m
Blackadder	m
Blackheart	m
Blade	m
Blagden Packaging	m
Blair	m
Blake	m
Blanca	f
Blanchard	m
Blancke	m
Blankert	m
Blatter	m
Blavatsky	f
Blijlevens	m
Blix	m
Block	m
Blocksje	f
Bloem
Blofeld	m
Blokker	m
Blom	m
Blommaert	m
Blomqvist	m
Blondeel	m
Blondel	m
Blonk	m
Bloom	f
Bluegate	m
Blunt	m
Blutch	m
Bo	f
Boas	m
Bob	m
Bob Dylan	m
Bob Marley	m
Bob Peeters	m
Boban	m
Bobbejaan Schoepen	m
Bobbi	f
Bobbie
Bobby	m
Boccaccio	m
Bock	m
Bockor	m
Bodart	m
Bode Miller	m
Bodil	f
Bodo	m
Boebka	m
Boedapester	m
Boedapestse	f
Boeddha	m
Boekarester	m
Boekarestse	f
Boelens	m
Boeotiër	m
Boermans	m
Boet	m
Bogaert	m
Bogaerts	m
Bogarde	m
Bogdan	m
Bogers	m
Bogotaan	m
Bogotaanse	f
Bogtstra	m
Boheemse	f
Bohemer	m
Bohemerin	m
Bohemund	m
Boi	m
Boisjoly	m
Bojan	m
Bojana	f
Bokassa	m
Bolat	m
Boleslav	m
Boleslaw	m
Bolesław	m
Boliviaan	m
Boliviaanse	f
Bolkestein	m
Bollen	m
Bolt	m
Bomans	m
Bommel	m
Bonaventura	m
Bond	m
Bongard	m
Bongers	m
Bonifacio	m
Bonifacius	m
Bonifatius	m
Bonnard	m
Bonnet	m
Bonnie	f
Bonny	f
Bono	m
Bontekoe	m
Bontje	f
Bonzi	f
Booger	m
Boogerd	m
Boogschutter
Boom	m
Boomsma	m
Boon	m
Boone	m
Boonen	m
Boonstra	m
Boorman	m
Boot	m
Booy	m
Bor	m
Bora	m
Borat	m
Boreux	m
Borg	m
Borgers	m
Borges	m
Borghouts	m
Borgia	m
Borginon	m
Boris	m
Boris Jeltsin	m
Boris Tisjtsjenko	m
Boris Tsjaikovski	m
Borja	m
Borka	f
Borlée	m
Borms	m
Born	m
Borneose	f
Borneoër	m
Borodin	m
Borre	m
Borremans	m
Borsato	m
Borst	m
Bos	m
Boschker	m
Bose	m
Bosic	m
Bosjesman
Boskamp	m
Bosko	m
Bosko Balaban	m
Bosmans	m
Bosnische	f
Bosniër	m
Bosnjak	m
Bossche	f
Bosschenaar	m
Bossi	m
Bosvelt	m
Bot	m
Both	m
Botha	m
Botswaan	m
Botswaanse	f
Bouaouzan	m
Bouazza	m
Bouchat	m
Bouchouari	m
Bouckaert	m
Boudewijn	m
Boudewijn Büch	m
Boudewijn IV	m
Bouhouche	m
Bouke	m
Boukje	f
Bouman	m
Bourgeois	m
Bourgondische	f
Bourgondiër	m
Bourlet	m
Bousquet	m
Boussoufa	m
Bout	m
Bouteflika	m
Boutens	m
Bouterse	m
Boutros-Ghali	m
Bouwe	m
Bouwer	m
Bouwmeester	m
Bouyeri	m
Boven	m
Bovy	m
Bové	m
Bow	m
Bowe	m
Bowen	m
Bowie	m
Bowser	m
Bowy	m
Boy	m
Boyd	m
Boydens	m
Boye	m
Boyen	m
Boyle	m
Boze	m
Brabander	m
Brabantse	f
Bracke	m
Brackx	m
Brad	m
Brad Pitt	m
Bradley	m
Brady	m
Braet	m
Bragg	m
Brahim	m
Brahms	m
Brain	m
Braine	m
Brainpower	m
Bram	m
Bram Criel	m
Bram Eliaert	m
Bram Stoker	m
Bram Verbist	m
Bram Vermeulen	m
Bram de Groot	m
Branagh	m
Branco	m
Brand	m
Brandi	f
Brandina	f
Brando	m
Brandon	m
Brandt	m
Brandy	f
Branko	m
Branquinho	f
Branson	m
Branst	m
Brant	m
Bras	m
Braziliaan	m
Braziliaanse	f
Brazzaviller	m
Brazzavilse	f
Brecht	f
Brechtje	f
Bredase	f
Bredaër	m
Bregje	f
Bregtje	f
Brel	m
Bremer	m
Brenda	f
Brendan	m
Brendell	m
Brennan	f
Brenninkmeijer	m
Brent	m
Brentjens	m
Bresson	m
Bret	m
Breton	m
Brett	m
Breugelmans	m
Breukink	m
Brian	m
Brian May	m
Brian Vandenbussche	m
Brian Wilson	m
Briana	f
Brice	m
Brick	m
Bridges	m
Bridget	f
Bridget Jones	f
Bridget Maasland	f
Briek	m
Briers	m
Briggs	m
Bright	m
Brigit	f
Brigita	f
Brigitta	f
Brigitte	f
Bril	m
Brink	f
Brinkhorst	m
Brinkman	m
Briony	f
Brissot	m
Brit	m
Brita	f
Britney	f
Britney Spears	f
Britse	f
Britt	f
Britta	f
Brittany	f
Briçonnet	m
Brock	m
Broder	f
Broekmans	m
Broers	m
Bron	m
Bronislaw	m
Brood	m
Broodthaers	m
Brooke	f
Brooks	m
Broos	m
Brosnan	m
Brouns	m
Brouwer	f
Brouwers	m
Browaeys	m
Brown	m
Browne	m
Bruce	m
Bruce Springsteen	m
Bruce Wayne	m
Bruce Willis	m
Bruckner	m
Bruegel	m
Bruggeling	m
Bruggeman	m
Bruggink	m
Brugse	f
Bruin	m
Bruins Slot	m
Bruinsma	m
Bruna	f
Bruneau	m
Bruneel	m
Bruneier	m
Bruneise	f
Brunelleschi	m
Bruning	m
Bruno	m
Bruno Debo	m
Bruno Tuybens	m
Bruno Versavel	m
Brusselaar	m
Brusselmans	m
Brusselse	f
Brutus	m
Bruun	m
Bruyneel	m
Bruyninckx	m
Bryan	m
Bryan Adams	m
Bryant	m
Bryn	m
Bryon	m
Brys	m
Bryson	m
Bubis	m
Buch	m
Buchanan	m
Buck	m
Bucquoy	m
Bud	m
Buda	m
Buddy	m
Budi	m
Buell	m
Buenos Airees	m
Buffel	m
Buffett	m
Buffon	m
Buffy	f
Buijs	m
Buis	m
Bul Super	m
Bulent	m
Bulgaar	m
Bulgaarse	f
Bulle Bas	m
Bullock	f
Bulo	m
Burger	m
Burgers	m
Burke	m
Burkinees	m
Burkinese	f
Burns	m
Burnside	m
Burrell	m
Burrus	m
Burt	m
Burton	m
Burundees	m
Burundese	f
Busch	m
Buse	f
Bush	m
Busquin	m
Buster	m
Butters	m
Buttiglione	m
Button	m
Buunk	m
Buyens	m
Buys	m
Buyse	m
Buysse	m
Buñuel	m
Byakuya	m
Byrne	m
Byron	m
Bär	m
Béla	m
Bøkko	m
Büch	m
Bülent	m
Cadel Evans	m
Caderousse	m
Caesar	m
Cage	m
Cahill	m
Cahit	m
Caine	m
Cairo	m
Caitlin	f
Caius	m
Caja	f
Calabrese	f
Calabriër	m
Caldwell	m
Californische	f
Californiër	m
Caligula	m
Callens	m
Calles	m
Callewaert	m
Callie	f
Calvijn	m
Calvin	m
Camacho	m
Camara	m
Cambodjaan	m
Cambodjaanse	f
Cameron	m
Cameron Diaz	f
Camiel	m
Camilla	f
Camille	f
Camillo	m
Camilo	m
Campert	m
Campi	m
Campo	m
Camus	m
Canadees	m
Canadese	f
Canan	f
Canarische	f
Canariër	m
Cancellara	m
Candrix	m
Candy	f
Canetti	m
Cannavaro	m
Cantona	m
Cao Cao	m
Capello	m
Cappelle	m
Capriati	f
Captain Falcon	m
Cara	f
Caraceen	m
Caraceense	f
Caranthir	m
Caravaggio	m
Carel	m
Caren	f
Carestel	m
Carette	m
Carey	f
Carice	f
Carien	f
Carin	f
Carina	f
Carine	f
Carine Poelman	f
Carl	m
Carl Decaluwé	m
Carl Lewis	m
Carl Nielsen	m
Carla	f
Carleen	f
Carlette	f
Carli	f
Carlie	f
Carlien	f
Carlijn	f
Carline	f
Carlisle United	f
Carlito	m
Carlo	m
Carlo Bomans	m
Carlos	m
Carlos Ghosn	m
Carlton	m
Carly	f
Carmel	f
Carmela	f
Carmelo	m
Carmen	f
Caro	f
Carol	f
Carola	f
Carole	f
Carolien	f
Carolijn	f
Carolijne	f
Carolin	f
Carolina	f
Caroline	f
Caroline Gennez	f
Caroline Maes	f
Caroll	f
Carolus	m
Carolyn	f
Carpenter	m
Carr	m
Carrell	m
Carrey	m
Carrie	f
Carry	f
Carsten	m
Cartamundi	m
Carter	m
Cartman	m
Carton	m
Carus	m
Cas	m
Casanova	m
Casey	m
Cash !	m
Casier	m
Casillas	m
Casimir	m
Caspar	m
Casper	m
Cass	m
Cassander	m
Cassandra	f
Cassano	m
Cassatievoorzitter Londers	m
Cassidy	f
Cassie	f
Cassiers	m
Cassini	m
Cassius	m
Casteels	m
Castiliaan	m
Castiliaanse	f
Castracani	m
Castro	m
Cat	f
Cat Stevens	m
Catalaan	m
Catalaanse	f
Catarina	f
Cate	f
Catharina	f
Catharina de Grote	f
Catherine	f
Cathy	f
Cathérine	f
Cato
Catriona	f
Cats	m
Cavendish	m
Cavens	m
Caymaneilander	m
Caymaneilandse	f
Caïroot	m
Caïrotische	f
Ceausescu	m
Ceauşescu	m
Cecil	m
Cecile	f
Cecilia	f
Cederic	m
Cedric	m
Cedrick	m
Cees	m
Cees Nooteboom	m
Cees van Rootselaar	m
Cees van der Hoeven	m
Cela	m
Celan	m
Celebische	f
Celebiër	m
Celeste	f
Celestine	f
Celestino	m
Celia	f
Celie	f
Celil	m
Celinde	f
Celine	f
Celis	m
Celso	m
Celvin	m
Cem	m
Cemal	m
Cemil	m
Cena	m
Centraal-Afrikaan	m
Centraal-Afrikaanse	f
Cerezo	m
Ceri	f
Cerion	m
Cervantes	m
Cesar	m
Cesare	m
Ceulemans	m
Ceylan	f
Chaboseau	m
Chabot	m
Chad	m
Chagall	m
Chailly	m
Chaim	m
Chaira	f
Chaja	f
Cham	m
Chamberlain	m
Chambers	m
Chamisso	m
Chan	m
Chander	m
Chandler	m
Chandra	f
Chang	m
Channing	m
Chantal	f
Chao	m
Chaplin	m
Chapman	m
Charaï	m
Charlene	f
Charles	m
Charles Bronson	m
Charles Darwin	m
Charles Dickens	m
Charles Manson	m
Charley	m
Charlie	m
Charlie Chaplin	m
Charlie Sheen	m
Charlier	m
Charlize	f
Charlotte	f
Charlton	m
Charly	m
Charlène	f
Charmaine	f
Chas	m
Chastel	m
Chaucer	m
Chava	f
Chavanel	m
Chavez	m
Chaz	m
Chazia	f
Chaïm	m
Che	m
Chee	m
Chela	m
Chelsea	f
Chen	m
Cheney	m
Cheng	m
Cheppih	m
Cher	f
Cherie	f
Cherif	m
Cherilyn	f
Cherry	f
Cheruiyot	m
Cheryl	f
Cheryll	f
Chester	m
Chet	m
Chet Baker	m
Chevalier	m
Chi	m
Chiang Kai-shek	m
Chiara	f
Chiel	m
Chiem	m
Chileen	m
Chileense	f
Chin	m
Chinees	m
Chinese	f
Chingy	m
Chioma	f
Chip	m
Chirac	m
Chivington	m
Chivu	m
Chloe	f
Chloé	f
Chloë	f
Cho	m
Chodiev	m
Chodorkovski	m
Choi	m
Chomsky	m
Chong	m
Chopin	m
Chris	m
Chris Andries	m
Chris Finch	m
Chris Hageland	m
Chris Janssens	m
Chris Lomme	f
Chris Maene	m
Chris Van den Durpel	m
Chris Vincent	m
Chris van Abkoude	m
Chrisje	f
Chrissie	f
Christ	m
Christa	f
Christan	m
Christel	f
Christelle	f
Christensen	m
Christiaan	m
Christiaens	m
Christian	m
Christian Dior	m
Christian Dumolin	m
Christian Van Thillo	m
Christiane	f
Christianne	f
Christiano	m
Christiansen	m
Christie
Christien	f
Christijan	m
Christijan Albers	m
Christina	f
Christina Aguilera	f
Christine	f
Christl	f
Christmaseilander	m
Christmaseilandse	f
Christo	m
Christof	m
Christoff	m
Christoffel	m
Christoffel Columbus	m
Christoffer	m
Christon	m
Christoph	m
Christophe	m
Christophe Rochus	m
Christopher	m
Christopher Reeve	m
Christophorus	m
Christos	m
Christus	m
Christy	f
Chroesjtsjov	m
Chrétien	m
Chuck	m
Chun	m
Chung	m
Churchill	m
Chávez	m
Chérie	f
Ciara	f
Ciarán	m
Cicely	f
Cicero	m
Cihan	m
Cilly	f
Cindy	f
Cinta	f
Cintha	f
Cipollini	m
Ciro	m
Cisca	f
Ciska	f
Cisse Severeyns	m
Cissy	f
Cissé	m
City Bird	m
City Hotels	m
Civilis	m
Claartje	f
Claas	m
Claes	m
Claesen	m
Claessens	m
Claeys	m
Claire	f
Clapton	m
Clara	f
Clare	f
Clarence	m
Clarence Seedorf	m
Clarine	f
Clark	m
Clark Gable	m
Clarke	m
Clarysse	m
Clas Thunberg	m
Claude	m
Claudette	f
Claudia	f
Claudia Pechstein	f
Claudie	f
Claudine	f
Claudio	m
Claudius	m
Claudius Ptolemaeus	m
Claudy	f
Claus	m
Clay	m
Clays	m
Clayton	m
Clear Channel	m
Cleese	m
Clemence	f
Clemenceau	m
Clemens	m
Clement	m
Clementina	f
Clementine	f
Clen	m
Cleo	f
Cleon	m
Cleopatra	f
Cleysters	f
Cliff	m
Clifford	m
Cliften	m
Clijsters	f
Clinique	m
Clint	m
Clint Eastwood	m
Clinton	m
Cliteur	m
Clive	m
Clooney	m
Clotilde	f
Clouseau	m
Clouzot	m
Clovis	m
Clyde	m
Clémence	f
Clément	m
Co	m
Co Adriaanse	m
Cobie	f
Cobox	m
Coby	f
Cochise	m
Cock	m
Cockerell	m
Cockerill	m
Coco	f
Cocquyt	m
Cocu	m
Coddens	m
Cody	m
Coeck	m
Coelho	m
Coen	m
Coene	m
Coenen	m
Coenraad	m
Coenradus	m
Coert	m
Coetzee	m
Cofinimmo	m
Cohen	m
Cohn	m
Cois	m
Cole	m
Coleman	m
Colet	f
Colette	f
Coligny	m
Colijn	m
Colin	m
Colla	m
Colleen	f
Collen	m
Collette	f
Collier	m
Collin	m
Collins	m
Colombiaan	m
Colombiaanse	f
Colpaert	m
Colsaerts	m
Commeyne	m
Comoor	m
Comoorse	f
Compernolle	m
Conan	m
Conceiçao	m
Conceição	m
Conchita	f
Condi	f
Confucius	m
Congolees	m
Congolese	f
Conner	m
Connie	f
Connie Palmen	f
Connolly	m
Connor	m
Connors	m
Conny	f
Conor	m
Conrad	m
Conradus	m
Constance	f
Constans	m
Constant	m
Constant Vanden Stock	m
Constantijn	m
Constantijn Huygens	m
Constantijn de Grote	m
Constantin	m
Constantine	f
Constantino	m
Constantinus	m
Constantius	m
Constanze	f
Contador	m
Conti	m
Cook	m
Cooke	m
Cookeilander	m
Cookeilandse	f
Cools	m
Cooper	m
Coopman	m
Cooreman	m
Coos	m
Coosje	f
Copeland	m
Copernicus	m
Coppens	m
Coppins	m
Coppola	m
Cor	m
Cor Boonstra	m
Cora	f
Coralie	f
Corbeels	m
Cordier	m
Corey	m
Coria	m
Corien	f
Corin	f
Corina	f
Corine	f
Corinne	f
Corinne Debaets	f
Coritiba	f
Corman	m
Corneille	m
Cornel	m
Cornelia	f
Cornelis	m
Cornelisz	m
Cornelius	m
Cornell	m
Cornelus	m
Cornillie	m
Cornu	m
Corné	m
Corri	f
Corrie	f
Corrina	f
Corrine	f
Corrinne	f
Corry	f
Cors	m
Corsicaan	m
Corsicaanse	f
Corso	m
Corstiaan	m
Cortés	m
Cosgrove	f
Cosmas	m
Costa	m
Costaricaan	m
Costaricaanse	f
Costello	m
Coster	m
Costner	m
Cosyns	m
Coucke	m
Coulthard	m
Couperin	m
Couperus	m
Coupet	m
Courtney	f
Courtois	m
Cousins	m
Couzijn	m
Couzy	m
Coveliers	m
Cowell	m
Cox	m
Coëme	m
Crabbé	m
Craig	m
Crane	m
Craven	m
Craxi	m
Cray	m
Crazy Fm	m
Creemers	m
Cremers	f
Cresson	f
Crevits	f
Crick	m
Criel	m
Cris	m
Crispijn	m
Cristian	m
Cristiano	m
Cristiano Ronaldo	m
Cristina	f
Cristina Fernandez	f
Cristine	f
Croes	m
Cros	m
Cross	m
Crouwel	m
Crowe	m
Cruijff	m
Cruise	m
Crum	m
Cruz	m
Crystal	f
Cubaan	m
Cubaanse	f
Cuban	m
Cubillas	m
Culek	m
Culina	m
Cumerio	m
Cunego	m
Cunningham	m
Cuno	m
Cuper	m
Currie	m
Curt	m
Curtis	m
Custer	m
Custers	m
Custovic	m
Cutler	m
Cuypers	m
Cyntha	f
Cynthia	f
Cyprianus	m
Cyprioot	m
Cypriotische	f
Cyriel	m
Cyril	m
Cyrille	m
Cyrillus	m
Cyrus	m
Czeslaw	m
Cárdenas	m
Cécile	f
Cédric	m
Cédric Van Branteghem	m
Céleste	f
Céline	f
César	m
Cézanne	m
D'Alema	m
D'Annunzio	m
D'Hondt	m
D'Hoore	m
D'Onofrio	m
DDT	m
Da Costa	m
Da Silva	m
Da Vinci	m
Daaf	m
Daan	m
Daan Remmerts de Vries	m
Dachung	m
Dadd	m
Daems	m
Daerden	m
Dafne	f
Dag Allemaal	m
Dagmar	f
Dagobert	m
Dagobert Duck	m
Dahl	m
Dahmane	m
Dai	m
Daisy	f
Dajo	m
Dakota	f
Dale	m
Dales	m
Daley	m
Dalglish	m
Dali	m
Dalida	f
Dalmatische	f
Dalmatiër	m
Dalton	m
Daly	m
Dalí	m
Damasceense	f
Damascener	m
Damen	m
Damiaan	m
Damian	m
Damiano	m
Damiano Cunego	m
Damien	m
Damir	m
Damián	m
Damiën	m
Damman	m
Damon	m
Dan	m
Dan Brown	m
Dana	f
Dana Brants	m
Dana Winner	f
Danah	f
Dane	m
Danel	m
Dang	m
Dani	m
Danica	f
Danie	f
Daniel	m
Daniel Barenboim	m
Daniel Van Buyten	m
Daniela	f
Daniela Hantuchova	f
Daniele	m
Daniella	f
Danielle	f
Daniels	m
Daniil	m
Danijel	m
Danilo	m
Danis	m
Danièle	f
Daniël	m
Daniël Termont	m
Daniël Van Buyten	m
Daniëla	f
Daniëlle	f
Daniëls	m
Dankert	m
Danko	m
Dann	m
Danneels	m
Dannis	m
Danny	m
Danny Blind	m
Danny C.	m
Danny Dierckx	m
Danny Huysmans	m
Danny Temmerman	m
Danny Verelst	m
Dante	m
Dany	m
Danyel	m
Daphne	f
Daphny	f
Daphné	f
Dara	f
Darcis	m
Darcy	m
Dario	m
Darius	m
Darko	m
Darla	f
Darlene	f
Daron	m
Darrel	m
Darrell	m
Darren	m
Darrin	m
Darryl	m
Darth Vader	m
Daryl	m
Daryll	m
Dasatinib	m
Dash	m
Dashao	f
Dassen	m
Date	m
Dato	m
Daud	m
Daumier	m
Dave	m
Dave Holland	m
Davenport	f
Davey	m
Davi	m
David	m
David Beckham	m
David Bierens de Haan	m
David Bouchat	m
David Bowie	m
David Cameron	m
David Coulthard	m
David D.	m
David Foulon	m
David Hilbert	m
David Lynch	m
David Maslanka	m
David Matthews	m
David Triantafillidis	m
David Van Ooteghem	m
David Villa	m
Davide	m
Davide Rebellin	m
Davids	m
Davidson	m
Davies	m
Davino Verhulst	m
Davis	m
Davor	m
Davy	m
Davy De Beule	m
Davy Vercauteren	m
Davydenko	m
Dawkins	m
Dawn	f
Day	f
Dayan	m
Dayenne	f
Dayna	f
Dayton	m
De Backer	m
De Batselier	m
De Bie	m
De Bilde	m
De Bleeckere	m
De Block	m
De Bock	m
De Bondt	m
De Bruin	m
De Bruyn	m
De Bruyne	m
De Cabooter	m
De Clerck	m
De Clercq	m
De Cock	m
De Coene	m
De Coninck	m
De Craene	m
De Croo	m
De Decker	m
De Dijcker	m
De Gaulle	m
De Geer	m
De Gelder	m
De Geus	m
De Graaf	m
De Graaff	m
De Graeve	m
De Grave	m
De Greef	m
De Groot	m
De Groote	m
De Gucht	m
De Haas	m
De Hoop Scheffer	m
De Jonge	m
De Jongh	m
De Jonghe	m
De Kock	m
De Koning	m
De Kort	m
De Kroes	m
De Lange	m
De Lannoy	m
De Leeuw	m
De Miranda	m
De Mol	m
De Moor	m
De Mos	m
De Mul	m
De Nijs	m
De Nooijer	m
De Pauw	m
De Poel	m
De Prins	m
De Ridder	m
De Roo	m
De Rooij	m
De Rooy	m
De Rossi	m
De Roy	m
De Ruijter	m
De Ruiter	m
De Ruyter	m
De Ruyver	m
De Ryck	m
De Schepper	m
De Schutter	m
De Smedt	m
De Smet	m
De Swaan	m
De Taeye	m
De Vilder	m
De Villepin	m
De Visser	m
De Vlaeminck	m
De Vlaming	m
De Vlieger	m
De Vries	m
De Waart	m
De Waele	m
De Wever	m
De Wijkerslooth	m
De Wilde	m
De Winne	m
De Winter	m
De Wispelaere	m
De Wit	m
De With	m
De Witte	m
De Wolf	m
De Zeeuw	m
De Zutter	m
De Zwaan	m
De boer	m
Dean	m
Debbie	f
Debby	f
Debby van der Schilt	f
Debie	m
Debir	m
Deboosere	m
Debora	f
Deborah	f
Deborah Gravenstijn	f
Debra	f
Debruyne	m
Deburghgraeve	m
Debusschere	m
Debye	m
Deceuninck	m
Decius	m
Deckers	m
Declan	m
Decleir	m
Declerck	m
Declercq	m
Decorte	m
Deddy	f
Dedecker	m
Dee	f
Deejay	m
Deelder	m
Deelkens	m
Deen	m
Deense	f
Deepak	m
Dees	m
Defour	m
Degelin	m
Degryse	m
Dehaene	m
Deirdre	f
Dejaeghere	f
Dejan	m
Dekelver	m
Dekeyser	m
Dekkers	m
Del Piero	m
Del Ponte	f
Dela	f
Delcroix	m
Deldaele	m
Delen	m
Deleu	m
Delfine	f
Delgado	m
Delia	f
Delmee	m
Delmulle	m
Deloof	m
Delphine	f
Delporte	m
Delrue	m
Delva	m
Delvaux	m
Deman	m
Demanet	m
Dembele	m
Dembélé	m
Dementieva	f
Demeter	f
Demetrius	m
Demeulemeester	m
Demeyer	m
Demeyere	m
Demi	f
Demi Moore	f
Demol	m
Demoor	m
Demotte	m
Demuynck	m
Den Bakker	m
Den Blijker	m
Den Uyl	m
Denert	m
Deng	m
Denijs	m
Denis	m
Denis Irwin	m
Denis Menchov	m
Denisa	f
Denise	f
Deniz	m
Denktash	m
Dennie	m
Dennie Christian	m
Dennis	m
Dennis Bergkamp	m
Dennis Edwards	m
Denny	m
Denys	m
Denzel	m
Depinois	m
Depla	m
Depoortere	m
Depp	m
Depraetere	m
Deprez	m
Dereeper	m
Derek	m
Derk	m
Derksen	m
Derrick	m
Derrida	m
Deruddere	m
Derya	f
Derycke	m
Des	m
Descamps	m
Descartes	m
Deschacht	m
Deschamps	m
Desi	f
Desiderius	m
Desire	f
Desiree	f
Desireé	f
Desiré	f
Desirée	f
Desmarest	m
Desmet	m
Desmond	m
Despiegelaere	m
Destexhe	m
Detlef	m
Detlev	m
Devaere	m
Devgen	m
Devi	m
Devika	f
Devine	m
Devisch	m
Devlin	m
Devolder	m
Devon	m
Devos	m
Devriendt	m
Dewael	m
Dewaele	m
Dewever	m
Dewilde	m
Dewinter	m
Dewulf	m
Dex	m
Dexter	m
Deyan	m
Dhani	m
Dheedene	m
Di	m
Di Gregorio	m
Di Luca	m
Di Rupo	m
DiCaprio	m
Diamond	m
Dian	f
Diana	f
Diane	f
Diane Arbus	f
Diann	f
Dianna	f
Dianne	f
Diaz	m
Diba	m
Dibaba	f
Dick	m
Dick Advocaat	m
Dick Bos	m
Dick Bruna	m
Dick Norman	m
Dickens	m
Dickie	m
Dicky	f
Dida	m
Diddy
Diderik	m
Diderot	m
Didi	f
Didier	m
Didier Bellens	m
Didier Dheedene	m
Didier Gosuin	m
Didier Mbenga	m
Didier Reynders	m
Didier Van Keymeulen	m
Didier de Vooght	m
Dido	f
Diederic	m
Diederick	m
Diederik	m
Diederike	f
Diego	m
Diego Maradona	m
Diem	m
Diemer	m
Dien	m
Dienke	f
Dierckx	m
Dierickx	m
Diet	f
Dieta	f
Dieter	m
Dieter Vanthourenhout	m
Dietmar	m
Dietrich	m
Dieuwke	f
Digital Equipment	m
Digna	f
Dijkstal	m
Dijkstra	m
Dik	m
Dilan	f
Dilbert	m
Dillon	m
Dilys	f
Dim	m
Dimitra	f
Dimitri	m
Dimitri Verhulst	m
Dimitrie	m
Dimitrios	m
Dimitris	m
Dimme	m
Dimphy	f
Dina	f
Dina Tersago	f
Dinah	f
Dinand	m
Dinesh	m
Dingane	m
Dingeman	m
Dini
Dino	m
Diny	f
Dio	m
Diogo	m
Dion
Dione	f
Dionisio	m
Dionne	f
Dionysios	m
Dionysius	m
Dionysos	m
Dior	m
Diponegoro	m
Dirck	m
Diriiye Yuusuf	m
Dirk	m
Dirk Bikkembergs	m
Dirk Clarysse	m
Dirk De Wolf	m
Dirk Demeersman	m
Dirk Frimout	m
Dirk Jacobs	m
Dirk Kuijt	m
Dirk Van Tichelt	m
Dirkjan	m
Dirkje	f
Dis	m
Distler	m
Distrigas	m
Dita	f
Dittrich	m
Divatox	f
Divera	f
Divine	f
Dixie	f
Djamel	m
Django	m
Djiboutiaan	m
Djiboutiaanse	f
Djibril	m
Djindjic	m
Djokovic	m
Djukanovic	m
Djutoris	m
Djûke	f
Dmitri	m
Dmitri Sjostakovitsj	m
Do	f
Dobbe	m
Dobbelaere	m
Dobby	m
Doc	m
Dochterlief	f
Dockx	m
Doctorow	m
Doeke	m
Doekle	m
Doeschka	f
Dogan	m
Doherty	m
Dokic	f
Dolf	m
Dollfuss	m
Dolly	f
Dollé	m
Dolomieter	m
Dolph	m
Domenech	m
Domenico	m
Domenico Modugno	m
Domien	m
Domingo	m
Domingus	m
Dominic	m
Dominic Foley	m
Dominicaan	m
Dominicaanse	f
Dominick	m
Dominiek	m
Dominik	m
Dominique
Dominique Baeyens	m
Dominique D'Onofrio	m
Dominique de Villepin	m
Domino	f
Domitianus	m
Don	m
Don Bosco	m
Don Carlos	m
Don Diego De La Vega	m
Don Leo	m
Don Quichot	m
Dona	f
Donald	m
Donald Allen Munez	m
Donald Duck	m
Donalda	f
Donatella	f
Donato	m
Donell	m
Dong	m
Dong Zhuo	m
Donia	f
Donkey Kong	m
Donn	m
Donna	f
Donner	m
Donners	f
Donnie	m
Donny	m
Donorio	m
Donovan	m
Doohan	m
Dooms	m
Door	f
Doornaert	f
Doornbos	m
Doortje	f
Dora	f
Dora Janssen	f
Dordrechtenaar	m
Dordrechtse	f
Doreen	f
Dorette	f
Dorian	m
Dorien	f
Dorinda	f
Dorinde	f
Dorine	f
Doris	f
Dorit	f
Dorknoper	m
Doron	m
Dorothea	f
Dorothee	f
Dorothy	f
Dorothée	f
Dorrestijn	m
Dorrie	f
Dorrit	f
Dorrith	f
Dorus	m
Dos Santos	m
Dostojevski	m
Dosunmu	m
Doug	m
Douglas	m
Douwe	m
Doyle	m
Draco Malfidus	m
Dragan	m
Drago	m
Draper	m
Draskovic	m
Dre	m
Drees	m
Drent	m
Drentse	f
Dresselhuys	f
Drew	m
Dreyfus	m
Driek	m
Dries	m
Dries Busselot	m
Dries Van Noten	m
Dries Vandenwijngaert	m
Drika	f
Driss	m
Drogba	m
Dronkoers	m
Drucker	m
Dré	m
Du Bois	m
Dua	f
Duane	m
Duarte	m
Dublinner	m
Dublinse	f
Dubois	m
Ducarme	m
Duchâtelet	m
Duco	m
Dudley	m
Dudu	f
Dufaux	m
Duff	m
Dufour	m
Duiker	m
Duinkerkenaar	m
Duinkerkse	f
Duisenberg	m
Duitse	f
Duitser	m
Dukas	m
Duke	m
Dulce	f
Dulles	m
Dulli	m
Dumont	m
Dumoulin	m
Duncan	m
Duncan Smith	m
Dunga	m
Dunlop	m
Dunne	m
Duplat	m
Dupont	m
Dupré	m
Dupuis	m
Durand	m
Durk	m
Dury	m
Dusan	m
Dustin	m
Dustin Hoffman	m
Dusty	m
Dutert	m
Duval	m
Duyn	m
Duyvendak	m
Dvořák	m
Dwain	m
Dwayne	m
Dwight	m
Dwyane Wade	m
Dyanne	f
Dylan	m
Dyonne	f
Dyson	m
Dzjengis Khan	m
Dénis	m
Désanne	f
Désiré	f
Désirée	f
Díaz	m
Dönitz	m
Dürer	m
Eamon	m
Eandis	m
Earl	m
Early	m
Eastwood	m
Eben	m
Eberhard	m
Ebi	m
Ebo	m
Ebrahim	m
Ebru	f
Ecclestone	m
Eckhart	m
Eco	m
Ecover	m
Ecuadoraan	m
Ecuadoraanse	f
Ed	m
Ed Maas	m
Ed Norvell	m
Ed van Thijn	m
Edberg	m
Edda	f
Eddie	m
Eddy	m
Eddy Merckx	m
Eddy Wally	m
Ede	m
Eden	f
Edgar	m
Edgar Davids	m
Edgard	m
Edgardo	m
Edine	f
Edison	m
Edit	f
Edita	f
Edith	f
Edith van Dijk	f
Editha	f
Edmond	m
Edmund	m
Edna	f
Edo	m
Edoardo	m
Edouard	m
Edsger	m
Edu	m
Eduard	m
Eduarda	f
Eduardina	f
Eduardo	m
Eduardus	m
Edvard	m
Edward	m
Edwards	m
Edwin	m
Edwin Evers	m
Edwin Jongejans	m
Edwin van der Sar	m
Edwina	f
Edzard	m
Edzo	m
Eeckhout	m
Eef	f
Eefje	f
Eefke	f
Eeke	f
Eelco	m
Eelke	m
Eelko	m
Eeltje	m
Eendracht	m
Eendracht Appelterre	m
Eenhoorn	m
Eerde	m
Eerdmans	m
Effi	f
Effie	f
Efraim	m
Efraïm	m
Egbert	m
Egbertina	f
Egemin	m
Egerszegi	f
Egidius	m
Egmond	m
Egmont	m
Egon	m
Egon Bahr	m
Egyptenaar	m
Egyptische	f
Ehsan	m
Ehud Barak	m
Ehud Olmert	m
Eibert	m
Eichel	m
Eijk	m
Eijkelkamp	m
Eike	f
Eiko	m
Eildert	m
Eileen	f
Eimbert	m
Eimert	m
Einar	m
Eindhovenaar	m
Eindhovense	f
Einstein	m
Eise	m
Eisenhower	m
Eisenman	m
Eisenstein	m
Eisner	m
Eisse	m
Eisso	m
Eite	m
Ekaterina	f
Eke	f
Ekrem	m
El	m
El Azzouzi	m
El Guerrouj	m
El_Harith	m
Ela	f
Elaine	f
Elanor	f
Elbert	m
Elbertus	m
Elco	m
Elena	f
Elena Dementieva	f
Eleni	f
Eleonora	f
Eleonore	f
Elfride	f
Elfriede	f
Elgar	m
Eli	m
Elia	m
Elian	m
Eliane	f
Elias	m
Elias Canetti	m
Elibert	m
Elie	m
Elies	f
Eligius	m
Elijah	m
Elike	f
Elin	f
Eline	f
Eline Berings	f
Elinor	f
Elio	m
Elio Di Rupo	m
Eliot	m
Elisa	f
Elisabet	f
Elisabeth	f
Elise	f
Elisha	f
Eliska	f
Elissa	f
Eliza	f
Elizabeth	f
Elizabeth Taylor	f
Elizah	f
Elkana	m
Elke	f
Elkeen	m
Elkhattabi	m
Ella	f
Elle	f
Elleke	f
Ellen	f
Ellert	m
Ellery	m
Elles	f
Elli	f
Ellian	m
Ellie	f
Ellie Vranken	f
Elliot	m
Elliott	m
Ellis	m
Ellison	m
Ellul	m
Elly	f
Elma	f
Elmar	m
Elmer	m
Elmo	m
Elna	f
Elodie	f
Eloi	m
Eloise	f
Elon	m
Eloy	m
Elroy	m
Els	f
Els Callens	f
Els De Schepper	f
Els Leemans	f
Els Van Doren	f
Elsa	f
Elsbeth	f
Else	f
Elsemieke	f
Elshout	m
Elsie	f
Elsje	f
Elske	f
Elsschot	m
Elton	m
Elton John	m
Eluard	m
Elvan	f
Elvin	m
Elvira	f
Elvis	m
Elvis Costello	m
Elvis Presley	m
Elyse	f
Elzasser	m
Elzasserin	f
Elène	f
Emakina	m
Eman	f
Emanuel	m
Emanuele	m
Emanuella	f
Emerson	m
Emery	m
Emese	f
Emese Hunyady	f
Emiel	m
Emil	m
Emile	m
Emile Mpenza	m
Emile Ratelband	m
Emilia	f
Emiliano	m
Emilie	f
Emilio	m
Emilio Ferrera	m
Emilio Platti	m
Emily	f
Emine	f
Eminem	m
Emir	m
Emke
Emma	f
Emmanuel	m
Emmanuelle	f
Emmenaar	m
Emmense	f
Emmy	f
Emo	m
Emre	m
Ena	f
Endre	m
Endstra	m
Enel	m
Engel	m
Engelbert	m
Engelbertus	m
Engelbrecht	m
Engelen	m
Engelhard	m
Engels	m
Engelse	f
Engelsman	m
Englebert	m
Enid	f
Enis	m
Enith	f
Ennio	m
Enno	m
Enoch	m
Enquist	f
Enrico	m
Enrique	m
Enschedese	f
Enschedeër	m
Ensor	m
Enver	m
Enzensberger	m
Enzo	m
Ephraïm	m
Epicurus	m
Epke	m
Eppo	m
Equatoriaal-Guineeër	m
Equatoriaal-Guinese	f
Eran	m
Erasmus	m
Erben	m
Erben Wennemars	m
Erdogan	m
Erens	m
Eric	m
Eric Baranyanka	m
Eric Gerets	m
Eric Torfs	m
Eric Van Meir	m
Eric Van Rompuy	m
Erica	f
Erica Terpstra	f
Erich	m
Erick	m
Eridanus	m
Erik	m
Erik Dekker	m
Erik Snel	m
Erik Van Looy	m
Erik Zabel	m
Erika	f
Eriksen	m
Erikson	m
Eriksson	m
Erin	f
Eritreeër	m
Eritrese	f
Erkan	m
Erkel	m
Erland	m
Erlend	m
Erma	f
Erman	m
Ermesinde	f
Erna	f
Ernest	m
Ernest Claes	m
Ernest Hemingway	m
Ernestine	f
Ernesto	m
Ernie	m
Ernie Els	m
Erno	m
Ernst	m
Erol	m
Eros	m
Eros Ramazzotti	m
Errol	m
Erroll	m
Ertan	m
Ervik	m
Ervin	m
Erwin	m
Erwin Vervecken	m
Erzsébet	f
Esad	m
Esajas	m
Esau	m
Escobar	m
Escudé	m
Eskil	m
Eskimo
Esma	f
Esme	f
Esmee	f
Esmé	f
Esmée	f
Espen	m
Espera	f
Esperanza	f
Espinoza	m
Esser	m
Essevee	m
Essien	m
Esson	m
Est	m
Esteban	m
Estelle	f
Ester	f
Esther	f
Estlander
Estse	f
Estée Lauder	f
Ethan	m
Ethel	f
Ethelbald	m
Ethiopische	f
Ethiopiër	m
Etienne	m
Etienne Schouppe	m
Eto'o	m
Etty	f
Euan	m
Euan Blair	m
Eudora	f
Eugen	m
Eugene	m
Eugenia	f
Eugenie	f
Eugenio	m
Eugenius	m
Eugène	m
Eugéne	m
Eulalia	f
Eurinpro	m
Europeaan	m
Europese	f
Eusebio	m
Eusebius	m
Eva	f
Eva Braun	f
Evan	m
Evander	m
Evangelina	f
Evangelos	m
Evans	m
Eve	f
Evelien	f
Evelin	f
Eveline	f
Evelyn	f
Evenepoel	m
Evens	m
Everard	m
Everett	m
Everhard	m
Everhardus	m
Everon	m
Evers	m
Evert	m
Evert van Benthem	m
Everts	m
Everwijn	m
Evi	f
Evi Hanssen	f
Evi Van Acker	f
Evita	f
Evy	f
Evy Gruyaert	f
Ewa	f
Ewald	m
Ewan	m
Ewell	m
Ewoud	m
Ewout	m
Excellentie
Eyad	m
Eyal	m
Eyskens	m
Ezechiël	m
Ezekiel	m
Ezio	m
Ezra	m
FCU|DRAGON|BE	f
FDP
Faas	m
Faber	m
Fabian	m
Fabian Cancellara	m
Fabiano	m
Fabien	m
Fabien Barthez	m
Fabienne	f
Fabio	m
Fabio Capello	m
Fabiola	f
Fabius	m
Fabiënne	f
Fabre	m
Fabregas	m
Fabrice	m
Fabrimetal	m
Fabrizio	m
Fabrizio Guidi	m
Fadil	m
Fadime	f
Fadma	f
Faeröerder	m
Faeröerse	f
Faes	m
Fagerholm	m
Fahd	m
Fahed	m
Fahim	m
Fahima	f
Faik	m
Faisal	m
Faith	f
Fake	m
Falco	m
Falk	m
Falklandeilander	m
Falklandeilandse	f
Falko	m
Fallon	m
Famke	f
Fania	f
Fanny	f
Faouzi	m
Farah
Farazijn	m
Faraö	m
Farhad	m
Faria	f
Farid	m
Farida	f
Farina	f
Farinelli	m
Farley	m
Farrah	f
Farrell	m
Farssi	m
Farzana	f
Fassbinder	m
Fassotte	m
Fatih	m
Fatima	f
Fatime	f
Fatma	f
Fatna	f
Faulks	m
Faustino	m
Fausto	m
Fay	f
Faye	f
Faysal	m
Febiac	m
Fedasil	m
Fedde	m
Federer	m
Federica	f
Federico	m
Fedja	m
Fedor	m
Fehriye Erdal	f
Feike	m
Feiko	m
Feisal	m
Feke	f
Fela	f
Feldher	m
Felice	m
Felicia	f
Felicity	f
Felicity Evren	f
Feliks	m
Felipe	m
Felipe MASSA	m
Felipe Massa	m
Felix	m
Fellaini	m
Fellini	m
Femi	f
Femke	f
Femke Dekker	f
Femme	f
Femmie	f
Femmy	f
Fenna	f
Fenneke	f
Fenno	m
Fenny	f
Feodor	m
Fer	m
Ferd	m
Ferda	f
Ferdi	m
Ferdie	m
Ferdinand	m
Ferdinando	m
Ferdy	m
Ferenc	m
Ference	m
Ferencz	m
Feret	m
Fergus	m
Ferguson	m
Ferhat	m
Ferid	m
Fermat	m
Fermi	m
Fermin	m
Fernand	m
Fernanda	f
Fernandes	m
Fernando	m
Fernando Alonso	m
Fernando Torres	m
Fernon	m
Ferrand	m
Ferraro	f
Ferrer	m
Ferrera	m
Ferrero	m
Ferri	m
Ferry	m
Ferry Maat	m
Feys	m
Fia	f
Fidel	m
Fidel Castro	m
Fieke	f
Field	m
Fien	f
Fientje Moerman	f
Fiers	m
Fifi	f
Figo	m
Fijische	f
Fijiër	m
Fikret	m
Filemon	m
Filiberke	m
Filip	m
Filip Dewinter	m
Filip Meirhaeghe	m
Filipijn	m
Filipijnse	f
Filippo	m
Filippus	m
Filips	m
Filips II	m
Filips de Goede	m
Filips de Schone	m
Fin	m
Fini	m
Finlay	m
Finley	m
Finn	m
Finrod	m
Finse	f
Fiona	f
Fiore	f
Firmin	m
Fischler	m
Fish	m
Fisher	m
Fisichella	m
Fitch	m
Fittipaldi	m
Fitzgerald	m
Fjodor	m
Flahaut	m
Flaubert	m
Flavia	f
Flavio	m
Fledderus	f
Fleischer	m
Flemming	m
Fletcher	m
Fleur	f
Flevolandse	f
Flint	m
Flip	m
Flip Kowlier	m
Flipkens	f
Flo	m
Floor	f
Floore	f
Floortje	f
Flor
Flor Koninckx	m
Flora	f
Florence	f
Florent	m
Florentijn	m
Florentijnse	f
Florentino Pérez	m
Florentinus	m
Flores	m
Florian	m
Floridienne	m
Florien	f
Florijn	m
Florimond	m
Florine	f
Floris	m
Floris de Vries	m
Florizoone	m
Flory	f
Floyd	m
Floyd Landis	m
Fluxys	m
Flynn	m
Flynt	m
Focko	m
Foeke	m
Fokke	m
Fokko	m
Foley	m
Folke	m
Folkert	m
Fonger	m
Fons	m
Fons de Poel	m
Fonteyn	m
Foote	m
Fop	m
Foppe	m
Foppe de Haan	m
Forbes	m
Ford	m
Forget	m
Forrest	m
Forsythe	m
Fortuyn	m
Foss	m
Fossett	m
Fost Plus	m
Foster	m
Fouad	m
Fouquet	m
Fourier	m
Fournier	m
Fourniret	m
Fowler	m
Fox	m
Fran	f
Franc	m
Frances	f
Francesca	f
Francesca Vanthielen	f
Francesco	m
Francesco Planckaert	m
Francesco Totti	m
Francien	f
Francies	m
Francina	f
Francine	f
Francis
Francis Ford Coppola	m
Francisca	f
Francisco	m
Franciscus	m
Franciska	f
Franck	m
Francky Dury	m
Franco	m
Francois	m
Francoise	f
Frank	m
Frank Beke	m
Frank Bomans	m
Frank De Bleeckere	m
Frank De Winne	m
Frank Galan	m
Frank Lampard	m
Frank Lloyd Wright	m
Frank Raes	m
Frank Rijkaard	m
Frank Sinatra	m
Frank Slaets	m
Frank Vandenbroucke	m
Frank Vercauteren	m
Frank Verstraeten	m
Frank Zappa	m
Frank de Boer	m
Franka	f
Franke	m
Franken	m
Frankie	m
Frankie Vercauteren	m
Franklin	m
Franky	m
Franky Van der Elst	m
Franky Vercauteren	m
Franquin	m
Frans	m
Frans Bauer	m
Frans Brüggen	m
Frans Ferdinand	m
Frans Hals	m
Frans I	m
Frans II	m
Frans Jozef	m
Frans Van De Ven	m
Frans Verleyen	m
Frans-Guyaan	m
Frans-Guyaanse	f
Frans-Polynesische	f
Frans-Polynesiër	m
Franse	f
Fransien	f
Fransje	f
Fransman	m
Franstalige
Franz	m
Franz Beckenbauer	m
Franz Marijnen	m
Franziska	f
Franziska van Almsick	f
Franziskus	m
Française	f
François	m
François Sterchele	m
Françoise	f
Fraser	f
Fraukje	f
Frea	f
Freark	m
Fred	m
Freddie	m
Freddy	m
Freddy Caen	m
Freddy Maertens	m
Freddy Willockx	m
Frederic	m
Frederic Dupré	m
Frederich	m
Frederick	m
Frederico	m
Frederiek	f
Frederieke	f
Frederik	m
Frederik Hendrik	m
Frederik II	m
Frederik Van Lierde	m
Frederik Willem	m
Frederika	f
Frederike	f
Frederikus	m
Frederique	f
Fredrik	m
Fredriksson	f
Freek	m
Freek de Jonge	m
Freerk	m
Freire	m
Freke	f
Frenk	m
Frenken	m
Frenkie	m
Freriks	m
Freud	m
Freund	m
Frey	m
Freya	f
Freya Van den Bossche	f
Frida	f
Fridrich Bruk	m
Fridtjof	m
Frieda	f
Frieda Van Wijck	f
Friedel	f
Friedhelm	m
Friedrich	m
Friedrich Kellner	m
Fries	m
Friesinger	f
Frieza	m
Friezin	f
Frigo	m
Frisk	m
Friso	m
Frith	m
Fritjof	m
Frits	m
Frits Abrahams	m
Frits Bolkestein	m
Frits Spits	m
Fritz	m
Fritzl	m
Frodo	m
Froger	m
Frost	m
Frouja	m
Frouke	f
Froukje	f
Frumkin	m
Frutiger	m
Frutos	m
Fry	m
Frère	m
Fré	m
Fréderique	f
Frédéric	m
Frédéric Herpoel	m
Frédérique	f
Frémont	m
Fu Manchu	m
Fuad	m
Fuat	m
Fuchs	m
Fuentes	m
Fujimori	m
Fujita	m
Fulco	m
Fuller	m
Funda	f
Furyk	m
Fusarri	m
Félix	m
Fëanor	m
Gaastra	m
Gabi	f
Gabonees	m
Gabonese	f
Gabor	m
Gabriel	m
Gabriel Rios	m
Gabriela	f
Gabriele	f
Gabriella	f
Gabrielle	f
Gabriël	m
Gabriëla	f
Gabriëlla	f
Gabriëlle	f
Gabriëls	m
Gaby	f
Gaby Demanet	m
Gachot	m
Gaddafi	m
Gael	m
Gaetano	m
Gaga	f
Gail	f
Gaius	m
Galba	m
Galbraith	m
Galerius	m
Galiciër	m
Galileeër	m
Galilei	m
Galina	f
Galis	m
Galle	m
Galliano	m
Gallus	m
Galois	m
Galvez	m
Gambiaan	m
Gambiaanse	f
Gamelin	m
Ganda	m
Gandalf	m
Ganina	f
Gantman	m
Gaone	m
Garbo	f
Garcia	m
García	m
García Márquez	m
Gardner	m
Gardonne	m
Gareth	m
Gargamel	m
Garibaldi	m
Garmt	m
Garner	m
Garni	m
Garrett	m
Garrido	m
Garry	m
Garson	f
Gary	m
Garzelli	m
Gaspar	m
Gaspard	m
Gaspart	m
Gaspercic	m
Gaston	m
Gates	m
Gatlin	m
Gatze	m
Gaudí	m
Gauguin	m
Gauke	m
Gaumont	m
Gaurav	m
Gautama Boeddha	m
Gavin	m
Gavino	m
Gay	m
Gaye	m
Gazi	m
Gaël	m
Gaëlle	f
Gaëlle Mys	f
Gbagbo	m
GdF	m
Gea	f
Gebrselassie	m
Gedeon	m
Geebelen	m
Geel	m
Geels	m
Geeraerts	m
Geerke	f
Geert	m
Geert Bourgeois	m
Geert De Vlieger	m
Geert Hammink	m
Geert Hautekiet	m
Geert Hoste	m
Geert Lambert	m
Geert Mak	m
Geert Vercammen	m
Geert Versnick	m
Geert Wilders	m
Geerten	m
Geerten Meijsing	m
Geertjan	m
Geertje	f
Geertrui	f
Geertruida	f
Geerts	m
Geesink	m
Geeske	f
Geiserik	m
Geja	f
Geke	f
Gelbrich	f
Gelderlander	m
Gelderse	f
Gelijn	m
Gellius	m
Gembo	m
Gemma	f
Gemser	m
Gene	m
Gene Brems	m
Geneva	f
Geneviève	f
Genna	f
Gennez	f
Gentenaar	m
Gentse	f
Genuees	m
Genuese	f
Geoff	m
Geoffrey	m
Geoffrey Demeyere	m
Geoffrey Peytier	m
Geoffry	m
Georg	m
George	m
George Bush	m
George Clooney	m
George Dyson	m
George Gershwin	m
George Hincapie	m
George III	m
George Michael	m
George Orwell	m
George W. Bush	m
Georges	m
Georges Heylens	m
Georges Leekens	m
Georgette	f
Georgia	f
Georgiana	f
Georgie	m
Georgiev	m
Georgina	f
Georgine	f
Georgio	m
Georgios	m
Georgische	f
Georgius	m
Georgiër	m
Georgy	m
Gepke	f
Ger	m
Geraerts	m
Gerald	m
Geraldine	f
Geraldo	m
Geralt	m
Gerard	m
Gerard Ekdom	m
Gerard Mortier	m
Gerard Reve	m
Gerard van Velde	m
Gerardo	m
Gerardus	m
Gerben	m
Gerbert	m
Gerbrand	m
Gerbrands	m
Gerbrandy	m
Gerbrant	m
Gerbrig	f
Gerco	m
Gerd	m
Gerda	f
Gerdi	f
Gerdie	f
Gerdien	f
Gerdy	f
Gerets	m
Gergiev	m
Gergjev	m
Gerhard	m
Gerhardt	m
Geri	f
Gerie	f
Gerit	m
Gerke	m
Gerlach	m
Gerlinde	f
Gerlof	m
Germ	m
Germaan	m
Germain	m
Germaine	f
Germaine Necker	f
Germanicus	m
Germano	m
Gerolf	m
Gerolf Annemans	m
Geronimo	m
Gerrard	m
Gerret	m
Gerrie	f
Gerris	m
Gerrit	m
Gerrit Achterberg	m
Gerrit Komrij	m
Gerrit Schellens	m
Gerrit Zalm	m
Gerritjan	m
Gerritsen	f
Gerrold	m
Gerry	f
Gershwin	m
Gerson	m
Gert	m
Gert Steegmans	m
Gert Verheyen	m
Gertha	f
Gerti	f
Gertie	f
Gertjan	m
Gertje	f
Gertrud	f
Gertrude	f
Gertrudis	f
Gertruud	f
Gerty	f
Gervais	m
Gerwin	m
Gery	f
Gesink	m
Gessner	m
Geudens	m
Geurt	m
Geurts	f
Gewichtheffer Tom Goegebuer	m
Gezelle	m
Gezinus	m
Ghanees	m
Ghanese	f
Ghassan	m
Ghislain	m
Ghislaine	f
Ghita	f
Ghosn	m
Giacomo	m
Gian	m
Gian Maria	m
Giancarlo	m
Giancarlo Fisichella	m
Gianfranco	m
Giani	m
Gianluca	m
Gianna	f
Gianne	f
Gianni	m
Gianni Romme	m
Gibbs	m
Gibraltarees	m
Gibraltarese	f
Gibson	m
Gideon	m
Gidi	m
Gido	m
Gidon	m
Giedo	m
Giel	m
Giel Beelen	m
Gielen	m
Giesbert	m
Gigi	f
Gijs	m
Gijsbert	m
Gijsbertus	m
Gijsbrecht	m
Gijsel	m
Gijsje	f
Gil	m
Gil Vandenbrouck	m
Gila	f
Gilbert	m
Gilberto	m
Gilberto Simoni	m
Gilda	f
Giles	m
Gilian	m
Gilius	m
Gilles	m
Gilles De Bilde	m
Gilles de Bilde	m
Gilles de Rais	m
Gillet	m
Gilliam	m
Gilliams	m
Gillian	f
Gilligan	m
Gillis	m
Gilmore	m
Gils	m
Gina	f
Ginette	f
Ginger	f
Ginny	f
Gino	m
Gio	m
Giolitti	m
Giordano	m
Giorgi	m
Giorgia	f
Giorgio	m
Giorgio Armani	m
Giorgio de Chirico	m
Giovanni	m
Giovanni Arnolfini	m
Giovanni Visconti	m
Girard	m
Giraud	m
Gisbert	m
Gisbertus	m
Giscard	m
Gisela	f
Gisele	f
Giselinde	f
Gispen	m
Gisèle	f
Gita	f
Gitta	f
Gitty	f
Giulia	f
Giuliani	m
Giuliano	m
Giulietta	f
Giulio	m
Giuseppe	m
Given	m
Gizella	f
Gizenga	m
Gladys	f
Glaurung	m
Glen	m
Glenda	f
Glenn	m
Glenn Theys	m
Glenn Verbauwhede	m
Global Graphics	m
Gloria	f
Gloub	m
Glynis	f
Gnarelle	f
Goar	m
God	m
Godefroot	m
Godelieve	f
Godeliva	f
Godert	m
Godett	m
Godfried	m
Godfried van Bouillon	m
Godfroid	m
Godwin	m
Goebbels	m
Goedele	f
Goedele Liekens	f
Goedkoop	m
Goemans	m
Goeminne	m
Goetelen	m
Goethals	m
Goethe	m
Gohan	m
Gokhan	m
Goku	m
Gold	m
Golda	f
Goldie	f
Goldsmith	m
Gomes	m
Gonnie	f
Gonny	f
Gonny van Oudenallen	f
Gonzales	m
Gonzalez	m
Gonzalo	m
González	m
Goodman	m
Goof	m
Goofy	m
Goor	m
Goos	m
Goossen	m
Goossens	m
Goots	m
Goovaerts	m
Goran	m
Gorbatsjov	m
Gordon	m
Gordon Brown	m
Gore	m
Gorgias	m
Gorgoroth	m
Goris	m
Gorius	m
Gorky	m
Gorter	m
Gosse	m
Gosuin	m
Gottfried	m
Gottlieb	m
Gottlieb Daimler	m
Goud	m
Goudket	m
Gould	m
Govaert	m
Goven	m
Govert	m
Govinda	m
Graafland	m
Grabbe	m
Grace	f
Gracia	f
Graciano	m
Graciela	f
Grad	m
Grady	m
Graeme	m
Graham	m
Graham Poll	m
Grammens	m
Grandjean	m
Grant	m
Grass	m
Grassmann	m
Gray	m
Graziano	m
Greco	m
Green	m
Greenaway	m
Greene	m
Greenspan	m
Greet	f
Greetchen	f
Greg	m
Greg LeMond	m
Greg Van Avermaet	m
Gregg	m
Gregor	m
Gregorius	m
Gregory	m
Gregory Joseph	m
Greipel	m
Grenadaan	m
Grenadaanse	f
Greta	f
Gretchen	f
Grete	f
Gretha	f
Gretha Smit	f
Grieg	m
Griek	m
Griekse	f
Griet	f
Griet Buelens	f
Grietje	f
Griffin	m
Griffith	m
Grim	m
Grimbergen	m
Griselda	f
Groenendaal	m
Groenewold	m
Groenlander	m
Groenlandse	f
Groenveld	f
Grondin	m
Groninger	m
Groningse	f
Groothuis	m
Grootjans	m
Gross	m
Grote Pier	m
Grote Smurf	m
Grouchy	m
Grovestins	m
Gruber	m
Grunberg	m
Gruner	m
Gré	f
Grégoire	m
Grönholm	m
Grünholz	m
Grýla	f
Guadelouper	m
Guadeloupse	f
Guamees	m
Guamese	f
Guardiola	m
Guatemalaan	m
Guatemalaanse	f
Gudrun	f
Guerini	m
Guerrero	m
Guevara	m
Guido	m
Guido Brepoels	m
Guilherme	m
Guillaume	m
Guillermo	m
Guilliano	m
Guillou	m
Guinee-Bissauer	m
Guinee-Bissause	f
Guineese	f
Guineeër	m
Guise	m
Guiseppe	m
Gulay	f
Guliano	m
Gullit	m
Gunda Niemann-Kleemann	f
Gunda Niemann-Stirnemann	f
Gunilla	f
Gunnar	m
Guno	m
Guns	m
Gunter	m
Gunter Thiebaut	m
Gunther	m
Guo	m
Gus	m
Gust	m
Gusta	f
Gustaaf	m
Gustaaf Adolf	m
Gustaf	m
Gustav	m
Gustave	m
Gustavo	m
Guus	m
Guus Hiddink	m
Guusje	f
Guust	m
Guust Flater	m
Guy	m
Guy Cassiers	m
Guy Gilleman	m
Guy Raskin	m
Guy Smet	m
Guy Thys	m
Guy Verhofstadt	m
Guyaan	m
Guyaanse	f
Guzmán	m
Gwen	f
Gwendolyn	f
Gwijde	m
Gwyneth	f
Gwyneth Paltrow	f
Gyanendra	m
Gysbert	m
Gysel	m
Gyula	m
György	m
Gábor	m
Gé	m
Gérald	m
Gérard	m
Gérard Mestrallet	m
Géza	m
Gómez	m
Gödel	m
Gökhan	m
Göran	m
Göring	m
Gösta	m
Gül	f
Gülay	f
Gülizar	f
Gülnaz	f
Gülseren	f
Gümüs	m
Günter	m
Günther	m
Gürsel	m
Haagse	f
Haaije	m
Haak	m
Haakon	m
Haan	m
Haarhuis	m
Haarlemmer	m
Haarlemse	f
Haas	m
Haasbroek	m
Haase	m
Habermas	m
Habib	m
Habibie	m
Habran	m
Haci	m
Hadassa	f
Hadassah	f
Haddon	m
Hades	m
Hadewijch	f
Hadewych	f
Hadi	m
Hadise	f
Hadrianus	m
Haeck	m
Haek	m
Haelterman	m
Haemers	m
Haesaert	m
Haffmans	f
Hafid	m
Hagar	f
Hage	m
Hagen	m
Hagenaar	m
Hager	f
Hagi	m
Hagrid	m
Hahn	m
Hahnemann	m
Haidar	m
Haider	m
Haig	m
Haile Gebrselassie	m
Haitam	m
Haitham	m
Hajo	m
Hakan	m
Hakeem	m
Hakim	m
Hakima	f
Hakkinen	m
Hal	m
Halder	m
Hale	f
Halil	m
Halim	m
Halina	f
Halle Berry	f
Halsema	f
Haman	m
Hamdi	m
Hamed	m
Hamel	m
Hamid	m
Hamide	f
Hamidou	m
Hamilton	m
Hamish	m
Hamma Hammami	m
Hammer	m
Hammerstein	m
Hammond	m
Hamsun	m
Hamza	m
Hamzah	m
Han	m
Hana	f
Hanaan	f
Hanan	f
Hanane	f
Hanco	m
Handan	f
Handley Page	m
Hanegraaf	m
Hanif	m
Hanifa	f
Haniyeh	m
Hanja	f
Hank	m
Hanka	f
Hanks	m
Hanna	f
Hanna Mariën	f
Hannah	f
Hanne	f
Hanneke	f
Hanneke Groenteman	f
Hannelore	f
Hannes	m
Hanni	f
Hannibal	m
Hannie	f
Hanno	m
Hanny	f
Hanoch	m
Hanoier	m
Hanoise	f
Hans	m
Hans Blankert	m
Hans Blix	m
Hans Cornelis	m
Hans De Wolf	m
Hans Dijkstal	m
Hans Eichel	m
Hans Hausser	m
Hans Hoogervorst	m
Hans Kesting	m
Hans Klok	m
Hans Teeuwen	m
Hans Van Temsche	m
Hans Visser	m
Hans van Vliet	m
Hans van den Broek	m
Hansen	m
Hansen Transmissions	m
Hansje	f
Hanson	m
Hantuchova	f
Hapoel	m
Happart	m
Happel	m
Harald	m
Hardy	m
Hari	m
Haring	m
Hariri	m
Haris	m
Harley	m
Harm	m
Harm van Veldhoven	m
Harma	f
Harman	m
Harmans	m
Harmen	m
Harmes	f
Harminus	m
Harmke	f
Harmon	m
Harmony	f
Haro	m
Haroen	m
Harold	m
Haroon	m
Harper	m
Harrald	m
Harrer	m
Harri	m
Harrie	m
Harriet	f
Harrington	m
Harris	m
Harrison	m
Harrison Ford	m
Harrit	m
Harriët	f
Harriëtte	f
Harro	m
Harry	m
Harry Mulisch	m
Harry Potter	m
Hart	m
Harte	m
Harthoorn	m
Hartley	m
Hartman	m
Hartmann	m
Hartog	m
Harun	m
Harvey	m
Hasan	m
Hashim	m
Hasi	m
Hasna	f
Haspengouwer	m
Haspengouwse	f
Hassan	m
Hasse	f
Hasselaar	m
Hasselbaink	m
Hasseltse	f
Hassen	m
Hatice	f
Hatim	m
Hauke	m
Hauspie	m
Hava	f
Havanees	m
Havanese	f
Hawking	m
Hawkins	m
Hay	m
Haya	f
Hayat	f
Haydar	m
Hayden	m
Haydn	m
Haye	m
Hayes	m
Hayley	f
Haylie	f
Hayo	m
Haytham	m
Hazel	f
Hazem	m
Hazes	m
Hazim	m
Haïtiaan	m
Haïtiaanse	f
Heather	f
Heather Mills	f
Hebe	f
Hebridiaan	m
Hebridiaanse	f
Hector	m
Heddy	f
Hedi	f
Hedman	m
Hedrick	m
Hedwig	f
Hedy	f
Hedzer	m
Heer	m
Heer Bommel	m
Heer Voldemort	m
Heere	m
Heeren	m
Heertje	m
Heerts	m
Heesters	m
Hegel	m
Heidegger	m
Heideman	m
Heidi	f
Heihachi	m
Heijmans	m
Heike	f
Heikki	m
Heiko	m
Heiland	m
Heilbron	m
Hein	m
Hein Vanhaezebrouck	m
Heine	m
Heineken	m
Heinkel	m
Heinrich	m
Heinrich Engelhard Steinweg	m
Heinrich Himmler	m
Heinsbroek	m
Heintze	m
Heinz	m
Heinze	m
Heist	m
Heister	m
Heitinga	m
Heitor Villa-Lobos	m
Hekkensluiter Brussels	m
Helder	m
Heldring	m
Heleen	f
Helen	f
Helena	f
Helene	f
Helga	f
Helge	m
Hella	f
Helle	f
Hellen	f
Helleputte	m
Helma	f
Helmer	m
Helmert	m
Helmi	f
Helmich	m
Helmie	f
Helms	m
Helmut	m
Helmut Kohl	m
Helmut Lotti	m
Helmuth	m
Helsen	m
Helsinkische	f
Helsinkiër	m
Helène	f
Hemingway	m
Hemmo	m
Hemor	m
Henderson	m
Hendler	f
Hendrick	m
Hendrick van Doerne	m
Hendrickje	f
Hendrickx	m
Hendricus	m
Hendrie	m
Hendrieke	f
Hendrik	m
Hendrik I	m
Hendrik II	m
Hendrik III	m
Hendrik IV	m
Hendrik VI	m
Hendrik VIII	m
Hendrika	f
Hendrike	f
Hendrikje	f
Hendriks	m
Hendrikus	m
Hendrikx	m
Hendrix	m
Hendry	m
Henegouwer	m
Henegouwse	f
Heng	m
Henja	f
Henk	m
Henk Goovaerts	m
Henk Houwaart	m
Henke	f
Henkie	m
Henkjan	m
Henman	m
Henna	f
Henne	m
Hennie	f
Henning	m
Henno	m
Henny	f
Henri	m
Henricus	m
Henrieke	f
Henriette	f
Henrij	m
Henrik	m
Henrik Ibsen	m
Henrike	f
Henrique	m
Henriët	f
Henriëtte	f
Henry	m
Henry Ford	m
Henryk	m
Hens	m
Hensley	m
Henson	m
Hent	m
Henze	m
Hepburn	f
Herald	m
Heras	m
Herben	m
Herbert	m
Herbertus	m
Herco	m
Hercules	m
Herfkens	f
Hergé	m
Heribert	m
Herjan	m
Herma	f
Herman	m
Herman Brusselmans	m
Herman De Croo	m
Herman Helleputte	m
Herman Leus	m
Herman Schueremans	m
Herman Van Holsbeeck	m
Herman Van Rompuy	m
Hermance	f
Hermann	m
Hermannus	m
Hermanus	m
Hermelien	f
Hermen	m
Hermes	m
Hermie	f
Hermien	f
Hermina	f
Hermine	f
Hermione	f
Hermès	m
Hero	m
Herodes	m
Herpoel	m
Herr Seele	m
Herre	m
Herremans	m
Hersh	m
Herta	f
Hertmans	m
Hertzog	m
Hervé	m
Herwig	m
Herzberg	m
Hes	m
Hesham	m
Heske	f
Hess	m
Hesse	m
Hessel	m
Hester	f
Hette	m
Hetty	f
Heule	m
Heusdens	m
Hewitt	m
Heydrich	m
Heyerick	m
Heymans	m
Heyvaert	m
Hicham	m
Hicks	m
Hidayet	m
Hidde	m
Hiddema	m
Hiddink	m
Hideyoshi	m
Hieke	f
Hiele	m
Hielke	m
Hiep Hieper	m
Hieronymus	m
Highsmith	f
Hijme	m
Hilaerts	m
Hilaire	m
Hilal	f
Hilarius	m
Hilary	f
Hilbert	m
Hilbrand	m
Hilda	f
Hilde	f
Hildebrand	m
Hildegard	f
Hildo	m
Hill	m
Hillary	f
Hillary Clinton	f
Hillebrand	m
Hillen	m
Hillenius	m
Hillie	f
Hilmi	m
Hilversummer	m
Hilversumse	f
Himmler	m
Hinault	m
Hindrik	m
Hingis	f
Hinke	f
Hippocrates	m
Hira	f
Hirsi Ali	f
Hirst	m
Hirvonen	m
Hisham	m
Hiske	f
Hitch	m
Hitchcock	m
Hitler	m
Hizkia	m
Hiëronymus	m
Hjalmar	m
Ho	m
Hobbes	m
Hocus Pas	m
Hodge	m
Hoekman	f
Hoekstra	m
Hoessein	m
Hoessein Kamel	m
Hoet	m
Hoffman	m
Hofland	m
Hofman	m
Hofstede	m
Hol	m
Holden	m
Holger	m
Hollander	m
Hollandse	f
Holleeder	m
Hollerith	m
Holly	f
Holofernes	m
Holvoet	m
Homer	m
Hommes	m
Hondurees	m
Hondurese	f
Hong	m
Hongaar	m
Hongaarse	f
Hongkonger	m
Hongkongse	f
Honorius	m
Honoré	m
Hood	m
Hooft	m
Hoogervorst	m
Hoogspringster Tia Hellebaut	f
Hooker	m
Hoover	m
Hope
Hopkins	m
Hopper	m
Horatio	m
Horn	m
Horner	m
Horst	m
Hossam	m
Hossein	m
Hoste	m
Hotse	m
Hotze	m
Houellebecq	m
Houter	m
Houthoofd	m
Houwaart	m
Hove	m
Hovhaness	m
Howard	m
Howard Carter	m
Howard Dean	m
Howard Hanson	m
Hoxha	m
Hrawi	m
Hristo	m
Hu	m
Hub	m
Hubbard	m
Huber	m
Hubert	m
Hubertina	f
Hubertus	m
Hubrecht	m
Huda	f
Huet	m
Huey	m
Hugh	m
Hugh Grant	m
Hughes	m
Hugo	m
Hugo Broos	m
Hugo Claus	m
Hugo Coveliers	m
Hugo Schiltz	m
Hugoline	f
Huib	m
Huibers	m
Huibrecht	m
Huig	m
Huisinga	m
Huisman	m
Huizenga	m
Huizinga	m
Humala	m
Humberto Tan	m
Humphrey	m
Humphrey Bogart	m
Hun
Hunt	m
Huntelaar	m
Hunter	m
Huntington	m
Huppert	f
Huriye	f
Huseyin	m
Hushovd	m
Hussein	m
Hutton	m
Huub	m
Huug	m
Huygelen	m
Huygens	m
Huygevoort	m
Huys	m
Huyse	m
Huysmans	m
Hélène	f
Höss	m
Hülya	f
Hünteler	m
Hürü	f
Hüseyin	m
IJsboerke	m
IJslander	m
IJslandse	f
Iain	m
Ian	m
Ian Fleming	m
Ianthe	f
Ib	m
Iban	m
Iberische	f
Iberiër	m
Ibo	m
Ibolya	f
Ibrahiem	m
Ibrahim	m
Ibrahim Salou	m
Ibrahimovic	m
Ibrahimović	m
Ibsen	m
Ice Cube	m
Ice-T	m
Ichigo	m
Icos	m
Ida	f
Idalina	f
Iddo	m
Ide	m
Idelette	f
Ido	m
Idries	m
Idris	m
Idriss	m
Ids	m
Ieke	f
Iemke	f
Ier	m
Ierse	f
Ies	m
Iet	f
Iggy	m
Ignace	m
Ignacio	m
Ignatius	m
Ignaz	m
Igor	m
Igor De Camargo	m
Ike	m
Iker	m
Ikhlas	f
Ilan	m
Ilda	f
Ildikó	f
Ileana	f
Ileen	f
Ilhan	m
Ilhan Mansiz	m
Ilia	m
Ilian	m
Iliescu	m
Ilija	m
Ilir	m
Ilja	f
Iljo	m
Iljo Keisse	m
Ilona	f
Ilonka	f
Ilse	f
Ilse Tielemans	f
Ilse Van Hoecke	f
Ilya	m
Ilyas	m
Imad	m
Imamura	m
Iman	f
Imca	f
Ime	m
Imelda	f
Imke	f
Immanuel	m
Immanuel Kant	m
Imme	f
Imme Dros	f
Immy	f
Imogen	f
Imran	m
Imre	m
Ina	f
Inan	m
Inbev	m
Indah	f
Inde	f
Indiaan	m
Indiaanse	f
Indiase	f
Indiaër	m
Indira	f
Indira Gandhi	f
Indische	f
Indiër	m
Indonesische	f
Indonesiër	m
Indra	f
Indurain	m
Ine	f
Ineke	f
Ines	f
Inez	f
Infrabel	m
Inga	f
Inge	f
Inge Becks	f
Inge Vervotte	f
Inge de Bruijn	f
Ingeborg	f
Ingemar	m
Inger	f
Ingmar	m
Ingo	m
Ingomar	m
Ingres	m
Ingrid	f
Ingvar	m
Iniesta	m
Inigo	m
Innocentius	m
Ino	f
Inuit
Inzaghi	m
Inès	f
Inèz	f
Inés	f
Ioan	m
Ioannis	m
Ion	m
Ira	f
Iraakse	f
Iraanse	f
Irakees	m
Iraniër	m
Irbesartan	m
Ireen	f
Ireen Wüst	f
Irena	f
Irenaeus	m
Irene	f
Irfan	m
Irina	f
Irina Rodnina	f
Iris	f
Irma	f
Irmgard	f
Irvin	m
Irving	m
Irwin	m
Isa	f
Isaac	m
Isaac Hayes	m
Isaac Newton	m
Isaak	m
Isabel	f
Isabell	f
Isabella	f
Isabelle	f
Isabelle A	f
Isabelle Huppert	f
Isac	m
Isaiah	m
Isaäc	m
Isaäk	m
Isaï	m
Ischa	m
Ishiaku	m
Isiah	m
Isidoor	m
Isidor	m
Isidorus	m
Isis	f
Iskender	m
Isla	f
Islam	m
Ismael	m
Ismail	m
Ismay	f
Ismaël	m
Ismene	f
Ismet	m
Isolde	f
Israel	m
Israël	m
Israëli
Israëlische	f
Israëliër	m
Issa	m
István	m
Itai	m
Italiaan	m
Italiaanse	f
Italo	m
Iva	f
Ivan	m
Ivan Basso	m
Ivan De Witte	m
Ivan Sonck	m
Ivano	m
Ivanov	m
Ivanovic	f
Ivar	m
Ivar Ballangrud	m
Ivens	m
Iversen	m
Iverson	m
Ivo	m
Ivo Niehe	m
Ivo Van Hove	m
Ivon	f
Ivone	f
Ivonne	f
Ivor	m
Ivoriaan	m
Ivoriaanse	f
Ivy	f
Iván	m
Iwan	m
Iyad	m
Izaak	m
Izabella	f
Izaline	f
Izaäk	m
Izetbegovic	m
Izzy	f
JC	m
JMDD	m
Jaak	m
Jaak Gabriëls	m
Jaan	m
Jaap	m
Jaap Stam	m
Jaap de Hoop Scheffer	m
Jaap van Zweden	m
Jaber	m
Jabik	m
Jabir	m
Jac	m
Jacco	m
Jacinta	f
Jacintha	f
Jacinto	m
Jack	m
Jack Bauer	m
Jack Nicholson	m
Jack Spijkerman	m
Jackie	f
Jackie Chan	m
Jackson	m
Jacky	m
Jacky Mathijssen	m
Jaco	m
Jacob	m
Jacob Zuma	m
Jacob van Maerlant	m
Jacoba	f
Jacoba van Beieren	f
Jacobi
Jacobien	f
Jacobine	f
Jacobs	m
Jacobson	m
Jacobus	m
Jacomijn	f
Jacomine	f
Jacqueline	f
Jacques	m
Jacques Brel	m
Jacques Chirac	m
Jacques Rogge	m
Jacques Santer	m
Jacques Vermeire	m
Jacques Villeneuve	m
Jacqui	f
Jad	m
Jada	f
Jade	f
Jaden	m
Jadranka	f
Jafar	m
Jafet	m
Jahjah	m
Jahweh	m
Jai	m
Jaime	m
Jaimy	m
Jair	m
Jairo	m
Jaja	m
Jak	m
Jakartaan	m
Jakartaanse	f
Jake	m
Jakko	m
Jakob	m
Jakobus	m
Jakop	m
Jakub	m
Jalal	m
Jalen	m
Jaliens	m
Jalil	m
Jamai	m
Jamaica	f
Jamaicaan	m
Jamaicaanse	f
Jamal	m
Jambers	m
Jamel	m
James	m
James Bond	m
James Brown	m
James Joyce	m
James Last	m
James Lovelock	m
James Potter	m
Jameson	m
Jamie	m
Jamie Oliver	m
Jamil	m
Jamila	f
Jan	m
Jan Callewaert	m
Jan Ceulemans	m
Jan De Clerck	m
Jan De Nul	m
Jan De Smet	m
Jan Decleir	m
Jan Decorte	m
Jan Douwe Kroeske	m
Jan Fabre	m
Jan Fets	m
Jan Ghyselinck	m
Jan Goossens	m
Jan Hoet	m
Jan Hoffmann	m
Jan Keizer	m
Jan Kruis	m
Jan Leyers	m
Jan Maes	m
Jan Masureel	m
Jan Moons	m
Jan Peeters	m
Jan Peter Balkenende	m
Jan Rap	m
Jan Rot	m
Jan Segers	m
Jan Six	m
Jan Smit	m
Jan Soetens	m
Jan Timman	m
Jan Ullrich	m
Jan Veerman	m
Jan Verheyen	m
Jan Walravens	m
Jan Wauters	m
Jan Wolkers	m
Jan van Eyck	m
Jana	f
Jancko	m
Janda	m
Jane	f
Janelle	f
Janet	f
Janey	f
Jango	m
Jango Fett	m
Jani	m
Janica	f
Janice	f
Janie	f
Janina	f
Janine	f
Janis	f
Janita	f
Janka	f
Janke	f
Janko	m
Jankovic	f
Janmaat	m
Janna	f
Janne	f
Janneke	f
Jannes	m
Jannet	f
Jannetje	f
Janni	f
Jannie	f
Jannik	m
Jannis	m
Janny	f
Jano	m
Janoekovitsj	m
Janoekovytsj	m
Janos	m
Jans	m
Jansen	m
Jansons	m
Jantien	f
Jantine	f
Jantje
Januarius	m
Janus	m
Janvier	m
Jany	f
Jap
Japanner	m
Japanse	f
Jappe	m
Jaquelien	f
Jaqueline	f
Jaques	m
Jaramillo	m
Jard	m
Jardel	m
Jared	m
Jarek	m
Jari	m
Jari Litmanen	m
Jarig	m
Jarju	m
Jarmila	f
Jarmo	m
Jarno	m
Jaromir	m
Jaroslav	m
Jarrett	m
Jart	m
Jaruzelski	m
Jascha	m
Jasey	m
Jasmijn	f
Jasmin	f
Jasmine	f
Jason	m
Jason Statham	m
Jasper	m
Jasperina	f
Jaspers	m
Jasser Arafat	m
Jassin	m
Jaumin	m
Javaan	m
Javaanse	f
Javi	m
Javier	m
Jawad	m
Jay	m
Jay-Z	m
Jayant	m
Jaymz	m
Jayne	f
Jayson	m
Jaël	f
Jean	m
Jean Marie Dedecker	m
Jean Paul Gaultier	m
Jean-Jacques	m
Jean-Luc	m
Jean-Luc Dehaene	m
Jean-Marc Guillou	m
Jean-Marc Jaumin	m
Jean-Marie	m
Jean-Marie Dedecker	m
Jean-Marie Le Pen	m
Jean-Marie Leblanc	m
Jean-Marie Pfaff	m
Jean-Michel Saive	m
Jean-Paul	m
Jean-Paul Gaultier	m
Jean-Paul Laenen	m
Jean-Paul van Gastel	m
Jean-Pierre	m
Jean-Pierre Bemba	m
Jean-Pierre Deraedt	m
Jeanet	f
Jeanette	f
Jeanine	f
Jeanique	f
Jeanne	f
Jeanneke	f
Jeannet	f
Jeannette	f
Jeannie	f
Jeannie Longo	f
Jeannine	f
Jeannot	m
Jeanny	f
Jeb	m
Jeda	f
Jeen	m
Jef	m
Jef Braeckevelt	m
Jef Delen	m
Jef Geeraerts	m
Jeff	m
Jefferey	m
Jefferson	m
Jeffery	m
Jeffrey	m
Jeffrey Archer	m
Jeffry	m
Jefke	m
Jefta	m
Jehu	m
Jelena	f
Jelger	m
Jelica	f
Jelinek	f
Jelis	m
Jelka	f
Jelle	m
Jelle Vossen	m
Jelleke	f
Jelles	m
Jellie	f
Jellina	f
Jelloul	m
Jelly	f
Jelmer	m
Jelte	m
Jeltje	f
Jelto	m
Jeltsin	m
Jem	m
Jemeniet	m
Jemenitische	f
Jen	m
Jena	f
Jenieke	f
Jenita	f
Jenkins	m
Jenkinson	m
Jenna	f
Jennart	m
Jenne	m
Jenneke	f
Jenner	m
Jennette	f
Jennie	f
Jennifer	f
Jennifer Aniston	f
Jennifer Capriati	f
Jennifer Lopez	f
Jennings	m
Jenny	f
Jeno	m
Jens	m
Jens Fink-Jensen	m
Jensen	m
Jenson	m
Jenson Button	m
Jente	f
Jentje	f
Jentsje	m
Jenö	m
Jeppe	m
Jeremia	m
Jeremiah	m
Jeremias	m
Jeremie	m
Jeremy	m
Jerke	m
Jerker	m
Jermain	m
Jermaine	m
Jerney	f
Jerobeam	m
Jeroen	m
Jeroen Bleekemolen	m
Jeroen Brouwers	m
Jeroen Devroe	m
Jeroen Dubbeldam	m
Jeroen Mellemans	m
Jeroen Olyslaegers	m
Jeroen van Inkel	m
Jerom	m
Jerome	m
Jerome Baugnies	m
Jeronimo	m
Jeronimus	m
Jerrel	m
Jerrel Hasselbaink	m
Jerry	m
Jerryl	m
Jerubbaäl	m
Jerusha	f
Jeruzalemmer	m
Jeruzalemse	f
Jerzy	m
Jerôme	m
Jesaja	m
Jeske	f
Jesper	m
Jespers	m
Jess	f
Jesse	m
Jesse Stroobants	m
Jessica	f
Jessie	f
Jessy	f
Jestrovic	m
Jet	f
Jetje	f
Jetske	f
Jetta	f
Jette
Jetteke	f
Jettie	f
Jetty	f
Jetze	m
Jewel	f
Jezus	m
Jezus Christus	m
Jheronimus	m
Jia	f
Jian	m
Jiang	m
Jiang Zemin	m
Jibril	m
Jigal	m
Jihad	f
Jikke	f
Jikkie	f
Jil	f
Jildou	f
Jill	f
Jillian	f
Jim	m
Jimi	m
Jimmie	m
Jimmy	m
Jimmy Carter	m
Jimmy Page	m
Jimmy Tielens	m
Jiménez	m
Jin	m
Jing	f
Jinke	f
Jip	m
Jippe	m
Jiri	m
Jiska	f
Jiske	f
Jismaël	m
Jitka	f
Jitske	f
Jitze	m
Jo
Jo Lernout	m
Jo Vally	m
Joab	m
Joachim	m
Joakim	m
Joan	f
Joana	f
Joane	f
Joanna	f
Joanne	f
Joanneke	f
Joannes	m
Joannis	m
Joao	m
Joaquim	m
Joaquin	m
Joaquín	m
Joas	m
Job	m
Job Cohen	m
Jobs	m
Jocelyn	f
Jochanan	m
Jochem	m
Jochem Uytdehaage	m
Jochen	m
Jochen Engelen	m
Jochum	m
Jock	m
Jodi	f
Jodie	f
Jodie Foster	f
Jodocus	m
Jody	f
Joe	m
Joe Van Holsbeeck	m
Joegoslavische	f
Joegoslaviër	m
Joek	m
Joekie	f
Joel	m
Joelle	f
Joep	m
Joep van den Nieuwenhuyzen	m
Joeri	m
Joeri Coomans	m
Joeri Jansen	m
Joes	m
Joesjenko	m
Joesjtsjenko	m
Joesoef	m
Joesoepov	m
Joey	m
Joffrey	m
Jogchem	m
Johan	m
Johan Boskamp	m
Johan Cruijff	m
Johan Demol	m
Johan Devriendt	m
Johan Friso	m
Johan Hendrik Weissenbruch	m
Johan II	m
Johan Museeuw	m
Johan Simons	m
Johan Van Hecke	m
Johan Vande Lanotte	m
Johan Vermeersch	m
Johan Verminnen	m
Johan de Witt	m
Johanan	m
Johann	m
Johann Sebastian Bach	m
Johanna	f
Johanna van Brabant	f
Johanne	f
Johanneke	f
Johannes	m
Johannes Brahms	m
Johannes Paulus	m
Johannes Paulus II	m
Johannes XXIII	m
Johannette	f
Johannis	m
Johansson	f
John	m
John Cale	m
John Cleese	m
John Coltrane	m
John F . Kennedy	m
John Galliano	m
John Goossens	m
John Kennedy	m
John Kerry	m
John Lennon	m
John Mc Cain	m
John McCain	m
John McEnroe	m
John O'Brien	m
John Travolta	m
John Wyclif	m
John de Mol	m
John van Lottum	m
Johnnie	m
Johnny	m
Johnny Cash	m
Johnny Depp	m
Johnson	m
Johnston	m
Johny	m
Joice	f
Jojo	m
Joke	f
Joke Houbrechts	f
Jol	m
Jola	f
Jolan	m
Jolanda	f
Jolande	f
Jolanthe	f
Jolene	f
Jolet	f
Jolie	f
Jolien	f
Jolien Sysmans	f
Jolijn	f
Jolin	f
Jolinda	f
Joline	f
Joly	f
Jomanda	f
Jon	m
Jona	m
Jonah	m
Jonas	m
Jonas Schepens	m
Jonatan	m
Jonathan	m
Jonathan Blondel	m
Jones	m
Jong	m
Jong CD&V	m
Jong VLD	m
Jonk	m
Jonker	m
Jonneke	f
Jonnie	m
Jonny	m
Jons	m
Jools	f
Joonas	m
Joop	m
Joop Zoetemelk	m
Joop van den Ende	m
Joos	m
Joost	m
Joost Bellaart	m
Joost Prinsen	m
Joost Zwagerman	m
Joosten	m
Jop	m
Joppe	m
Jor	m
Joram	m
Jord	m
Jordaanse	f
Jordan	m
Jordana	f
Jordanees	m
Jordanese	f
Jordaniër	m
Jordi	m
Jordy	m
Joren	m
Jorg	m
Jorge	m
Jorge Costa	m
Jorgen	m
Jorginho	m
Jorgos	m
Jori	m
Jorien	f
Jorik	m
Jorin	m
Jorinde	f
Jorine	f
Joris	m
Joris De Loore	m
Jorma	m
Jorn	m
Jorna	f
Jorre	m
Jorrit	m
Jorritsma	f
Jort	m
Jorunn	f
Jos	m
Jos Daerden	m
Jos Lansink	m
Jos Peeters	m
Jos Peters	m
Jos Vaessen	m
Jos Verstappen	m
Josafat	m
Jose
Josee	f
Josef	m
Josef Fritzl	m
Josefien	f
Josefina	f
Josefine	f
Josefus	m
Joseph	m
Joseph Kabila	m
Joseph Smith	m
Josephine	f
Josephus	m
Josette	f
Josh	m
Josha	m
Joshua	m
Joshua Coppins	m
Josia	m
Josiah	m
Josiane	f
Josie	f
Josien	f
Josine	f
Josip	m
Josita	f
Josje	f
Joske	f
Jospin	m
Josse	m
Josselien	f
Jostein	m
Josua	m
Josy	f
José	f
José Couso	m
José Happart	m
José Mourinho	m
Josée	f
Jouke	m
Joukje	f
Journey	f
Joustra	m
Jovan	m
Jovanovic	m
Joy	f
Joyce	f
Joycelin	f
Joycelyn	f
Jozef	m
Jozef II	m
Jozefien	f
Jozeph	m
Jozias	m
Jozias van Aartsen	m
Jozien	f
Jozina	f
Jozua	m
João	m
Joël	m
Joël Smets	m
Joëlle	f
Joëlle Milquet	f
Juan	m
Juan Carlos	m
Juan Carlos Ferrero	m
Juanfran	m
Juanita	f
Juba	m
Juda	m
Judah	m
Judas	m
Judas Makkabeüs	m
Jude	m
Judi	f
Judie	f
Judit	f
Judit Polgar	f
Judith	f
Judy	f
Juffermans	m
Juha	m
Juke	f
Jukka	m
Jule	f
Jules	m
Jules Verne	m
Juli	f
Julia	f
Julia Roberts	f
Juliaan	m
Julian	m
Juliana	f
Juliane	f
Julianus	m
Julie	f
Julieke	m
Julien	m
Julien Absalon	m
Juliet	f
Juliette	f
Julija	f
Julika	f
Julio	m
Julius	m
Julius Caesar	m
Julián	m
Juliëtte	f
Jullian	m
Julya	f
Jumana	f
Jun	m
June	f
Jung	m
Junghuhn	m
Juninho	m
Junior	m
Juno	f
Juppé	m
Jur	m
Jura	f
Juraj	m
Juran	m
Jure	m
Jurek	m
Jurg	m
Jurgen	m
Jurgen De Ridder	m
Jurgen Francois	m
Jurgen Van Goolen	m
Juri	m
Jurjen	m
Jurriaan	m
Jurrie	m
Jurrien	m
Jussi	m
Just	m
Justin	m
Justin Gatlin	m
Justin Timberlake	m
Justine	f
Justine Henin	f
Justine Henin-Hardenne	f
Justine Hénin	f
Justinianus	m
Justinus	m
Justus	m
Jusuf	m
Jutka	f
Jutlander	m
Jutlandse	f
Jutta	f
Juul	f
Juárez	m
János	m
Jérome	m
Jérôme	m
Jónathan	m
József	m
Jörg	m
Jörg Haider	m
Jörgen	m
Jörn	m
Jørgen	m
Jünger	m
Jürgen	m
Jürgen Klinsmann	m
Kaapstadse	f
Kaapstatter	m
Kaapverdische	f
Kaapverdiër	m
Kaat	f
Kabila	m
Kabir	m
Kabuler	m
Kabulse	f
Kaczynski	m
Kadafi	m
Kader	f
Kadhafi	m
Kafelnikov	m
Kagame	m
Kagawa	m
Kahan	m
Kai	m
Kai Reus	m
Kaj	m
Kakashi	m
Kakebeeke	f
Kaká	m
Kaletra	m
Kaley	f
Kalff	m
Kalina	f
Kalkman	m
Kalle	m
Kalou	m
Kamagurka	m
Kamal	m
Kamar	f
Kameroener	m
Kameroense	f
Kamiel	m
Kamil	m
Kamila	f
Kamille	f
Kamp	m
Kampusch	f
Kan	m
Kandinsky	m
Kane	m
Kankkunen	m
Kant	m
Kantonees	m
Kantonese	f
Kanu	m
Kapitein Barbosa	m
Kaplan	m
Kara	f
Karabulut	m
Karadzic	m
Karami	m
Karas	m
Kareem	m
Karel	m
Karel Aerts	m
Karel De Gucht	m
Karel Dillen	m
Karel Geraerts	m
Karel II	m
Karel IV	m
Karel Martel	m
Karel V	m
Karel Van Miert	m
Karel de Grote	m
Karel de Stoute	m
Karel van Gelre	m
Karel van Wolferen	m
Karelse	m
Karem	m
Karen	f
Karen Opdencamp	f
Karen Pollefeyt	f
Kari	f
Kariem	m
Karien	f
Karim	m
Karima	f
Karimov	m
Karin	f
Karin Donckers	f
Karina	f
Karine	f
Karinthische	f
Karinthiër	m
Karl	m
Karl Lagerfeld	m
Karl Marx	m
Karl Schäfer	m
Karl Vannieuwkerke	m
Karla	f
Karlijn	f
Karlović	m
Karol	m
Karola	f
Karolien	f
Karolijn	f
Karolina	f
Karoline	f
Karolus	m
Karpov	m
Karremans	m
Kars	m
Karskens	m
Karst	m
Karsten	m
Karsten Kroon	m
Kartika	f
Karzai	m
Kas	m
Kasavubu	m
Kasia	f
Kasimir	m
Kasjmiri	m
Kasjmirse	f
Kaspar	m
Kasparov	m
Kasper	m
Katalin	f
Katarina	f
Katarina Witt	f
Katarzyna	f
Kate	f
Kate Mintiens	f
Kate Moss	f
Kate Ryan	f
Katelijn	f
Katelijne	f
Katerina	f
Katerine	f
Katey	f
Kathalijne	f
Katharina	f
Katharine	f
Kathelijne	f
Katherina	f
Katherine	f
Kathinka	f
Kathleen	f
Kathleen Turner	f
Kathleen Van Brempt	f
Kathy	f
Kati	f
Katia	f
Katie	f
Katinka	f
Katja	f
Kato	f
Katrien	f
Katrien Verheecke	f
Katrijn	f
Katrina	f
Katsav	m
Katy	f
Kaufman	m
Kaukasische	f
Kaukasiër	m
Kaurismäki	m
Kaviedes	m
Kay	m
Kaya	f
Kayla	f
Kazach	m
Kazachse	f
Kazim	m
Kazimierz	m
Kazimir	m
Kazuya	m
Kea	f
Keane	m
Keanu	m
Keating	m
Keaton	m
Kee	f
Keegan	m
Keeler	f
Keely	f
Keen	m
Keenan	m
Kees	m
Kees van Wonderen	m
Keesje	f
Keetie	f
Keetje	f
Kei	m
Keimpe	m
Keisse	m
Keith	m
Keizer Karel	m
Keje	m
Kelchtermans	m
Kellan	m
Keller	m
Kelley	f
Kelly	f
Kelsey	f
Kelvin	m
Kemal	m
Kemkers	m
Kemna	m
Kempenaar	m
Kempense	f
Kempes	m
Ken	m
Ken De Dijker	m
Ken Kesey	m
Ken Loach	m
Kenan	m
Kenenisa Bekele	m
Keniaan	m
Keniaanse	f
Kenji	m
Kennedy	m
Kennes	m
Kenneth	m
Kenny	m
Kenny Jacobs	m
Kenny Laevaert	m
Kenny Vandenheede	m
Kenny Vanlaere	m
Kenny Werner	m
Kenshin	m
Kent	m
Kenzo	m
Kepler	m
Kerem	m
Keren	f
Keri	f
Kerim	m
Kerkorian	m
Kerlijne Everaet	m
Kerry	m
Kerst	m
Kersten
Kerstin	f
Kertész	m
Kerwin	m
Kesbir	f
Kesey	m
Kesler	m
Kess	f
Kessels	m
Kessler	m
Kestens	m
Kester	m
Kettmann	m
Keulenaar	m
Keulse	f
Keunen	m
Kevin	m
Kevin De Weert	m
Kevin Janssens	m
Kevin Pauwels	m
Kevin Roelandts	m
Kevin Van Acker	m
Kevin Van Impe	m
Kevin Van der Perren	m
Kevin Vandenbergh	m
Kevin Velle	m
Keyla	f
Keynes	m
Keyware	m
Kezman	m
Khadaffi	m
Khadafi	m
Khaddafi	m
Khadija	f
Khaled	m
Khalid	m
Khalil	m
Khan	m
Khartoemer	m
Khartoemse	f
Khatami	m
Khomeini	m
Khomeiny	m
Kian	m
Kick	m
Kid	m
Kidd	m
Kidman	f
Kiedis	m
Kiefer	m
Kieft	m
Kiek
Kieke	f
Kiekeboe	m
Kieling	m
Kieran	m
Kieron	m
Kik	m
Kika	f
Kiki	f
Kikker	m
Killian	m
Kim	f
Kim Clijsters	f
Kim Gevaert	f
Kim Jong-il	m
Kim Kirchen	m
Kim Vleminckx	f
Kimberley	f
Kimberly	f
Kimberly Buys	f
Kimberly Van der Jeught	f
Kimi	m
Kimi Raikkonen	m
Kimi Räikkönen	m
Kimman	m
Kimmo	m
Kin	m
King	m
King Lear	m
Kingsley	m
Kinneging	m
Kiplagat	f
Kipling	m
Kira	f
Kiran	m
Kircher	m
Kirchner	m
Kirgies	m
Kirgizische	f
Kiribatische	f
Kiribatiër	m
Kiril	m
Kirill	m
Kirk	m
Kirk Douglas	m
Kirsch	m
Kirsten	f
Kirsten Flipkens	f
Kirsty	f
Kistemaker	m
Kit	f
Kitano	m
Kitty	f
Kiymet	f
Kiyomori	m
Kjeld	m
Kjell	m
Kjersti	f
Kjetil Rekdal	m
Klaar	m
Klaartje	f
Klaas	m
Klaas Vantornout	m
Klaas de Vries	m
Klaasje	f
Klamer	m
Klara	f
Klasina	f
Klaske	f
Klaus	m
Klaver	m
Klazien	f
Klazina	f
Klein	m
Kleine	m
Kleis	m
Kleisterlee	m
Klett	m
Klevenaar	m
Klien	m
Klink	m
Klinkhamer	m
Klinsmann	m
Klok	m
Kloru	m
Klose	m
Kluivert	m
Klöden	m
Knaven	m
Knetemann	m
Knight	m
Knol	m
Knopper	m
Knox	m
Knuckles	m
Knud	m
Knudsen	m
Ko	m
Kobe	m
Kobe Bryant	m
Kobe Diels	m
Kobus	m
Koch	m
Kochnitzky	m
Kocsis	m
Koeman	m
Koen	m
Koen Crucke	m
Koen Daerden	m
Koen Meulenaere	m
Koen Persoons	m
Koen Van Donink	m
Koen Wauters	m
Koene	m
Koenigs	m
Koenitsyn	m
Koeno	m
Koenraad	m
Koeppen	m
Koerd	m
Koerdische	f
Koert	m
Koevermans	m
Koeweiter	m
Koeweitse	f
Kofi	m
Kofi Annan	m
Kohl	m
Koizumi	m
Kok	m
Koko	f
Kolinski	m
Koller	m
Kommer	m
Kompany	m
Komrij	m
Kong	m
Koninckx	m
Koning Albert	m
Koning Arthur	m
Koningin Beatrix	f
Konrad	m
Konstantin	m
Konstantinos	m
Konto	m
Kony	m
Kooijmans	m
Kooistra	m
Koolhaas	m
Koolhoven	m
Koons	m
Koop	m
Koopmans	m
Koos	m
Koosje	f
Kopenhaagse	f
Kopenhagenaar	m
Koppen	m
Korach	m
Koramic	m
Korda	m
Koreaan	m
Koreaanse	f
Koren	m
Korfioot	m
Korfiotische	f
Korine	f
Korinthische	f
Korinthiër	m
Kornelis	m
Korrie	f
Kors	m
Korthals	m
Korving	m
Korvinus	m
Kosovaar	m
Kosovaarse	f
Koss	m
Kosse	m
Kossmann	m
Kosta	m
Koster	m
Kostunica	m
Kouchner	m
Kouemaha	m
Kousbroek	m
Kouwenhoven	m
Kozlov	m
Koçak	m
Kraaijeveld	m
Krabbé	m
Kramer	m
Kramnik	m
Kranenborg	m
Kratos	m
Kraus	m
Kreeft
Kreizberg	m
Krekar	m
Kretenzer	m
Kretenzische	f
Kretschmer	m
Krijn	m
Krimmer	m
Krimse	f
Krimson	m
Kris	m
Kris Mennens	m
Kris Peeters	m
Krish	m
Krishna	m
Krispijn	m
Krist	m
Krista	f
Kristel	f
Kristen	f
Kristian	m
Kristie	f
Kristien	f
Kristien Hemmerechts	f
Kristijan	m
Kristin	f
Kristina	f
Kristine	f
Kristinsson	m
Kristof	m
Kristof Beyens	m
Kristof Imschoot	m
Kristof Peeters	m
Kristof Ragan	m
Kristof Snelders	m
Kristof Taillieu	m
Kristof Van Malderen	m
Kristof Vliegen	m
Kristy	f
Kristyl	f
Krkić	m
Kroaat	m
Kroatische	f
Kroes	f
Krol	m
Kronos	m
Kropholler	m
Krotwaar	m
Kruismans	m
Kruithof	m
Krul	m
Kruls	m
Kruys	m
Krystian	m
Krzysztof Penderecki	m
Ksenia	f
Kubala	m
Kubilskis	m
Kubrick	m
Kuhn	m
Kuifje	m
Kuijken	m
Kuijt	m
Kuiper	m
Kuipers	m
Kuno	m
Kunphela	m
Kuran	m
Kuros	m
Kuroslav Rados	m
Kurt	m
Kurt Cobain	m
Kurt Janssens	m
Kurt Van Torre	m
Kusturica	m
Kuyper	m
Kuypers	m
Kuyt	m
Kuznetsova	f
Kwame	m
Kwasniewski	m
Kwint	m
Kyara	f
Kyle	m
Kylian	m
Kylie	f
Kylie Minogue	f
Kyra	f
Kyrill	m
Károly	m
Käthe	f
Kérékou	m
Köhler	m
La	f
LaChapelle	m
LaCote	m
Laban	m
Labohm	m
Lacey	f
Lacoste	m
Lacoue-Labarthe	m
Lacroix	m
Ladan	f
Ladislaus	m
Lady Di	f
Lady Gaga	f
Laenen	m
Laenens	m
Laeremans	m
Laetitia	f
Lafeber	m
Laffitte	m
Lafontaine	m
Lagerfeld	m
Lahcen	m
Lai	f
Laila	f
Lainey	f
Lajos	m
Lakeman	m
Lakshmi	f
Lakshmi Mittal	m
Lamartine	m
Lamb	m
Lambert	m
Lamberto	m
Lambertus	m
Lambik	m
Lambo	m
Lambrecht	m
Lambrechts	m
Lamey	m
Lamine	m
Lammers	m
Lammert	m
Lammert Hartog	m
Lammertje	f
Lammi	f
Lampard	m
Lan	f
Lanah	f
Lancaster	m
Lance	m
Lance Armstrong	m
Lancelot	m
Lander	m
Landon	m
Landré	m
Landuyt	m
Landzaat	m
Lane	m
Lang	m
Lange Kadda	m
Langley	m
Lanoye	m
Lansink	m
Lansky	m
Lanz	m
Laocoön	m
Laotiaan	m
Laotiaanse	f
Lap	m
Lapaceen	m
Lapaceense	f
Laplandse	f
Laporta	m
Lara	f
Larbi	m
Lard	m
Larisa	f
Larissa	f
Laroes	m
Larry	m
Lars	m
Lars Boom	m
Lars von Trier	m
Larsen	m
Larson	m
Larsson	m
Laslo	m
Lassaut	m
Lasse	m
Laszlo	m
Latif	m
Latifa	f
Lau	m
Lauda	m
Laudrup	m
Laura	f
Laura Bush	f
Laura Lynn	f
Lauran	m
Laure	f
Lauren	f
Laurence	m
Laurence Himbert	f
Laurence Olivier	m
Laurens	m
Laurent	m
Laurent Jalabert	m
Laurentien	f
Laurentius	m
Laurenz	m
Laurette	f
Laurette Onkelinx	f
Lauri	f
Laurian	f
Laurie	f
Laurien	f
Lauris	m
Laury	f
Lauryn	f
Lauwers	m
Lavina	f
Lavinia	f
Law	m
Lawrence	m
Lay	m
Laya	f
Layla	f
Lazar	m
Lazrak	m
Laïla	f
Le Corbusier	m
Le Pen	m
Le Zoute	m
LeMond	m
Lea	f
Leah	f
Leander	m
Leandro	m
Leann	f
Leanna	f
Leanne	f
Lear	m
Leblanc	m
Lech Walesa	m
Leco	m
Ledda	m
Lee	m
Leeflang	m
Leekens	m
Leemans	f
Leen	m
Leen Demaré	f
Leendert	m
Leeroy	m
Leers	m
Leeson	m
Leeuw
Leeuwardense	f
Leeuwarder	m
Lefebvre	m
Lefevere	m
Lefevre	m
Legear	m
Lehmann	m
Lehto	m
Leibniz	m
Leidenaar	m
Leidse	f
Leif	m
Leif Hoste	m
Leif Kayser	m
Leigh	f
Leila	f
Leipheimer	m
Lejeune	m
Leko	m
Leleu	m
Lello	m
Lely	f
Lelystadse	f
Lelystatter	m
Lemaire	m
Leman
Lemaître	m
Lemke	f
Lemmens	m
Len	m
Lena	f
Lenaerts	m
Lene	f
Lenette	f
Lenette van Dongen	f
Leni	f
Leni Riefenstahl	f
Lenie	f
Lenin	m
Lenka	f
Lenn	m
Lennaert	m
Lennard	m
Lennart	m
Lenneke	f
Lennert	m
Lennie	f
Lennon	m
Lennox	m
Lenny
Leno	m
Lenoir	m
Lenore	f
Lens	m
Lense	m
Lenssen	m
Lenstra	m
Leny	f
Lenze	m
Leo	m
Leo Beenhakker	m
Leo Fender	m
Leo Merckx	m
Leon	m
Leon van Bon	m
Leona	f
Leonard	m
Leonard Bernstein	m
Leonarda	f
Leonarde	f
Leonardo	m
Leonardo Da Vinci	m
Leonardo da Vinci	m
Leonardus	m
Leone
Leonel	m
Leonhard	m
Leoni	f
Leonidas	m
Leonie	f
Leonne	f
Leonoor	f
Leonora	f
Leonore	f
Leontien	f
Leontina	f
Leontine	f
Leopold	m
Leopold I	m
Leopold II	m
Leopold III	m
Leopold Mozart	m
Leopoldus	m
Lepidus	m
Lepoint	m
Lepper	m
Lernout	m
Leroy	m
Les	m
Lesbische	f
Lesbiër	m
Lesley
Lesley Deckers	f
Leslie	m
Leslie Butkiewicz	f
Lesothaan	m
Lesothaanse	f
Lester	m
Lester Young	m
Let	m
Leterme	m
Leterme I	m
Letse	f
Letta	f
Lettie	f
Letty	f
Leukemans	m
Leurquin	m
Leuvenaar	m
Leuvense	f
Lev	m
Levent	m
Levi	m
Levi Leipheimer	m
Levien	m
Levin	m
Levine	f
Levinus	m
Levon	m
Levy
Lewis	m
Lewis HAMILTON	m
Lewis Hamilton	m
Lex	m
Leye	m
Leyers	m
Leyla	f
Leyla Zana	f
Leys	m
Leysen	m
Leïla	f
León	m
Li
Lia	f
Liam	m
Liane	f
Liang	m
Libanees	m
Libanese	f
Libbe	m
Liberace	m
Liberiaan	m
Liberiaanse	f
Libert	m
Libische	f
Libiër	m
Licia	f
Licinius	m
Lida	f
Lidewij	f
Lidewijde	f
Lidewy	f
Lidia	f
Lidwien	f
Lidwina	f
Lidy	f
Lidya	f
Lie	f
Liechtensteiner	m
Liechtensteinse	f
Liedeke	f
Liedewij	f
Lieke	f
Lien	f
Lieneke	f
Lies	f
Liesa	f
Liesbet	f
Liesbeth	f
Liese	f
Liesel	f
Lieselotte	f
Liesje	f
Lietaer	m
Lieuwe	m
Lieve	f
Lieve Beullens	m
Lieven	m
Lieven Scheire	m
Lievens	m
Ligthart	m
Ligurische	f
Liguriër	m
Lila	f
Lili	f
Lilian	f
Liliana	f
Liliane	f
Lillian	f
Lily	f
Lima	f
Liman	m
Limase	f
Limaër	m
Limb	f
Limburger	m
Limburgse	f
Lin	f
Lina	f
Lincoln	m
Linda	f
Linda de Mol	f
Lindbergh	m
Lindeman	m
Lindenberg	m
Lindh	f
Lindsay	f
Lindsay Davenport	f
Lindsey	f
Lindsey De Grande	f
Lindy	f
Line	f
Lineke	f
Ling	m
Linn	f
Linnaeus	m
Lino	m
Linus	m
Lion	m
Lionel	m
Lionel Messi	m
Lippens	m
Lippi	m
Lippits	m
Lisa	f
Lisandro	m
Lisanne	f
Lise	f
Liselore	f
Liselotte	f
Liset	f
Lisette	f
Lissabonner	m
Lissabonse	f
List	f
Liston	m
Liszt	m
Lita	f
Litmanen	m
Litouwer	m
Litouwse	f
Litvinenko	m
Liu	m
Liu Bei	m
Liu Yi	m
Liudger	m
Liuzzi	m
Liv	f
Livia	f
Livingstone	m
Livinus	m
Liz	f
Liza	f
Lizabeth	f
Lizet	f
Lizin	f
Lizzy	f
Ljapoenov	m
Ljiljana	f
Ljubojevic	m
Lleyton	m
Lleyton Hewitt	m
Llodra	m
Lloyd	m
Loana	f
Lode	m
Lodeiro	m
Lodewijk	m
Lodewijk IX	m
Lodewijk XI	m
Lodewijk XII	m
Lodewijk XIV	m
Lodewijk XV	m
Lodewijk XVIII	m
Lodewijk de Duitser	m
Lodewijk van Nassau	m
Lodewijks	m
Loe	m
Loeb	m
Loef	m
Loefje	f
Loek	m
Loek van Wely	m
Loekasjenko	m
Loeki	f
Loekie	f
Loekie van Maaren	f
Loes	f
Loesje	f
Loet	m
Loewenhaupt	m
Logan	m
Logghe	m
Lohse	m
Lois	f
Loix	m
Lola	f
Lolita	f
Lolke	m
Lolle	m
Lombaerts	m
Lombard	m
Lombardijse	f
Lomme	m
Londenaar	m
Londense	f
Londers	m
Lone	f
Long	m
Longstreet	m
Lonneke	f
Lonnie	f
Lonny	f
Looms	m
Loos	f
Lootens	m
Lopez	m
Loraine	f
Lord	m
Lord Hutton	m
Lordi	m
Lore	f
Loreen	f
Loren	f
Lorena	f
Lorentz	m
Lorenz	m
Lorenzo	m
Lorenzo Staelens	m
Loretta	f
Lorette	f
Lori	f
Lorin	f
Loris	m
Loris Reina	m
Lorna	f
Lornah Kiplagat	f
Lorrain	f
Lorraine	f
Losada	m
Lot	f
Lotfi	m
Lothar	m
Lotharinger	m
Lotharingse	f
Lotharius	m
Lotje	f
Lotte	f
Lotti
Lottie	f
Lotty	f
Lotz	m
Lou	m
Lou Reed	m
Loubna	f
Loudi	f
Loudon	m
Louie	m
Louis	m
Louis Armstrong	m
Louis Couperus	m
Louis Davids	m
Louis Michel	m
Louis Paul Boon	m
Louis Tobback	m
Louis Verbeke	m
Louis Vuitton	m
Louis van Gaal	m
Louisa	f
Louise	f
Louk	m
Loukas	m
Lourdes	f
Lourens	m
Lous	f
Lousewies van der Laan	f
Lout	m
Louter	m
Louw	m
Louwe	m
Louwerens	m
Louwes	m
Louwrens	m
Lovis	f
Lowe	m
Lowie	m
Loy	m
Loyd	m
Loyens	m
Loys	f
Luandees	m
Luandese	f
Luanne	f
Lubanga	m
Lubbers	m
Lubbert	m
Luc	m
Luc Appermont	m
Luc Cortebeeck	m
Luc De Vos	m
Luc Huyse	m
Luc Leys	m
Luc Maddelein	m
Luc Nilis	m
Luc Pauwels	m
Luc Tuymans	m
Luc Verschueren	m
Luca	m
Lucas	m
Lucebert	m
Lucette	f
Luci	f
Lucia	f
Lucian	m
Luciana	f
Luciano	m
Lucianus	m
Lucie	f
Lucien	m
Lucienne	f
Lucile	f
Lucille	f
Lucinda	f
Lucio	m
Lucius	m
Luciën	m
Luciënne	f
Lucky Luke	m
Lucrecia	f
Lucretia	f
Lucretius	m
Lucy	f
Lucy Loes	f
Lucía	f
Ludacris	m
Ludendorff	m
Ludger	m
Ludmilla	f
Ludo	m
Ludo Dierckxsens	m
Ludo Philippaerts	m
Ludo Van Campenhout	m
Ludolf	m
Ludolph	m
Ludovic	m
Ludovico	m
Ludovicus	m
Ludwig	m
Ludwig van Beethoven	m
Ludy	f
Luella	f
Lugo	m
Luigi	m
Luigi Pieroni	m
Luigino	m
Luikenaar	m
Luikse	f
Luis	m
Luis Aragones	m
Luis Enrique	m
Luis Figo	m
Luisa	f
Luise	f
Luit	m
Luiten	m
Luitzen	m
Luiz	m
Luk	m
Luka	m
Lukaku	m
Lukas	m
Luke	m
Lula	m
Lulof	m
Lulu	f
Lumet	m
Lumumba	m
Luns	m
Lusanne	f
Lutgarde	f
Luther	m
Luthor	m
Luud	m
Luuk	m
Luxemburger	m
Luxemburgo	m
Luxemburgse	f
Luyckx	m
Luyten	m
Luz	f
Luzac	m
Lydia	f
Lydie	f
Lygia	f
Lyn	f
Lynch	m
Lynda	f
Lyndon	m
Lynette	f
Lynn	f
Lynne	f
Lyon	m
Lyotard	m
Lysander	m
László	m
Léa	f
Léon	m
Léonard	m
Léonie	f
Léopoldine	f
Lévi	m
López	m
López Obrador	m
Lútsen	m
Lü Bu	m
M'hoteb	m
M.E.	p
ME'er
Ma	f
Maagd
Maaike	f
Maan	f
Maanu	m
Maarten	m
Maarten 't Hart	m
Maarten Lafeber	m
Maarten Luther	m
Maartje	f
Maartje van Weegen	f
Maas	m
Maase	m
Maaskant	m
Maassen	m
Maastrichtenaar	m
Maastrichtse	f
Maathai	f
Maati	m
Maayke	f
Mabel	f
Mabel Wisse Smit	f
Mac	m
MacDonald	m
Macauer	m
Macause	f
Macbeth	m
Macedonische	f
Macedoniër	m
Machiavelli	m
Machiel	m
Machlas	m
Machteld	f
Mack	m
Mackenzie	f
Madagas	m
Madagaskische	f
Madam Pheip	f
Madame Averino	f
Madame Edbouche	f
Maddelein	m
Maddie	f
Maddox	m
Maddux	m
Madeleine	f
Madeleine Albright	f
Madelon	f
Madero	m
Madhuri	f
Madické	m
Madison	f
Madoerees	m
Madoerese	f
Madoff	m
Madonna	f
Madrileen	m
Madrileense	f
Maduro	m
Mady	f
Mae	f
Maene	m
Maerten	m
Maertens	m
Maes	m
Maestro	m
Maeve	f
Magali	f
Magda	f
Magda Goebbels	f
Magdalena	f
Maggie	f
Maggy	f
Magna	m
Magneto	m
Magnificat	m
Magnus	m
Magriet	f
Magritte	m
Maguire	m
Mahathir	m
Mahdi	m
Maher	m
Mahesh	m
Mahler	m
Mahmood	m
Mahmoud	m
Mahmud	m
Mahmut	m
Mahy	m
Mai	f
Maia	f
Maier	m
Maik	m
Maike	f
Maikel	m
Maingain	m
Maja	f
Majella	f
Majid	m
Major	m
Majorie	f
Mak	m
Makaay	m
Makanaky	m
Makena	f
Makkink	m
Maks	m
Maksim	m
Mala	f
Malagassische	f
Malagassiër	m
Malawische	f
Malawiër	m
Malcolm	m
Malcolm Williamson	m
Maldini	m
Maldivische	f
Maldiviër	m
Maleisische	f
Maleisiër	m
Malena	f
Malfidus	m
Mali	f
Malica	f
Malick	m
Malik	m
Malika	f
Malin	f
Malinwa	m
Malische	f
Maliër	m
Malki	m
Malko	m
Mallorcaan	m
Mallorcaanse	f
Mallory	f
Malone	m
Malot	m
Maltees	m
Maltese	f
Mamadou	m
Mamouni	m
Man	m
Man Ray	m
Manar	f
Manasse	m
Mancebo	m
Manda	f
Mandela	m
Mandelson	m
Mandy	f
Manfred	m
Manger Cats	m
Manilleen	m
Manilleense	f
Mann	m
Mannie	f
Manoach	m
Manolis	m
Manolito	m
Manolo	m
Manolo Saiz	m
Manon	f
Manou	f
Manouk	f
Mans	m
Manset	m
Mansfeld	m
Manson	m
Mansour	m
Mansur	m
Mansveld	m
Mantell	m
Mantuaanse	f
Mantuaner	m
Manu	m
Manuel	m
Manuel Beltran	m
Manuela	f
Manus	m
Manuëla	f
Mao	m
Mao Zedong	m
Mar	f
Mara	f
Maradona	m
Marais	m
Maranka	f
Marat	m
Marat Safin	m
Marc	m
Marc Brys	m
Marc Cavendish	m
Marc Coucke	m
Marc Degryse	m
Marc Dutroux	m
Marc Helsen	m
Marc Hendrikx	m
Marc Herremans	m
Marc Jacobs	m
Marc Moulin	m
Marc Sleen	m
Marc Streel	m
Marc Van Peel	m
Marc Verwilghen	m
Marc Wagemakers	m
Marc Wauters	m
Marc Wilmots	m
Marca	f
Marceau	m
Marcel	m
Marcel Bich	m
Marcel Broodthaers	m
Marcel Duchamp	m
Marcel Habran	m
Marcel Kiekeboe	m
Marcel Vanthilt	m
Marcel van der Westen	m
Marceline	f
Marcelino	m
Marcella	f
Marcelle	f
Marcellino	m
Marcello	m
Marcello Lippi	m
Marcello Magnani	m
Marcellus	m
Marcelo	m
Marcha	f
Marchal	m
Marchel	m
Marchien	f
Marciano	m
Marcin	m
Marcinkiewicz	m
Marcio	m
Marck	m
Marco	m
Marco Borsato	m
Marco Pantani	m
Marco Zanotti	m
Marco van Basten	m
Marcoen	m
Marcos	m
Marcus	m
Marcus Antonius	m
Marcus Aurelius	m
Marcus Grönholm	m
Marcy	f
Mardulier	m
Mare	f
Maree	f
Mareike	f
Mareille	f
Marein	m
Marek	m
Marga	f
Margaret	f
Margaret Thatcher	f
Margareta	f
Margarete	f
Margareth	f
Margaretha	f
Margarethe	f
Margarita	f
Margarite	f
Marge	f
Margery	f
Margherita	f
Margie	f
Margien	f
Margit	f
Margje	f
Margo	f
Margon	f
Margot	f
Margreet	f
Margreeth	f
Margret	f
Margrethe	f
Margriet	f
Margrietha	f
Margrit	f
Marguerite	f
Margôt	f
Mari	m
Maria	f
Maria Callas	f
Maria Sharapova	f
Maria Sjarapova	f
Maria Stuart	f
Maria Theresia	f
Maria van Jever	f
Mariaan	m
Mariaanse	f
Mariah	f
Mariam	f
Marian	f
Mariana	f
Mariane	f
Marianna	f
Marianne	f
Marianne Thyssen	f
Marianne Timmer	f
Marianne Vlasveld	f
Mariano	m
Marie	f
Marie Louise	f
Marie-José	f
Marie-Louise	f
Marie-Rose	f
Mariechen	f
Mariecke	f
Marieke	f
Mariella	f
Marielle	f
Marien	m
Mariet	f
Marietje	f
Marietta	f
Mariette	f
Marij	f
Marija	f
Marijana	f
Marije	f
Marijke	f
Marijn	m
Marijnissen	m
Marika	f
Marike	f
Mariken	f
Mariko	f
Marilou	f
Marilu	f
Marilyn	f
Marilyn Monroe	f
Marilène	f
Marin	f
Marina	f
Marine	f
Marinel	f
Marines	m
Marinette	f
Marinis	m
Marinka	f
Marino	m
Marino Keulen	m
Marinus	m
Mario	m
Mario Aerts	m
Mario Cipollini	m
Mario Van Waeyenberge	m
Marion	f
Marion Jones	f
Marios	m
Maris	m
Marisa	f
Marisca	f
Marischka	f
Marise	f
Mariska	f
Marisol	f
Mariss Jansons	m
Marissa	f
Marit	f
Marita	f
Marith	f
Maritte	f
Maritza	f
Marius	m
Marius Mitu	m
Mariza	f
Mariël	f
Mariëlla	f
Mariëlle	f
Mariët	f
Mariëtta	f
Mariëtte	f
Marja	f
Marjan	f
Marjanka	f
Marjanne	f
Marjel	f
Marjelle	f
Marjet	f
Marjette	f
Marjo	f
Marjoke	f
Marjolein	f
Marjoleine	f
Marjolien	f
Marjolijn	f
Marjon	f
Marjorie	f
Mark	m
Mark Cavendish	m
Mark De Man	m
Mark Philippoussis	m
Mark Tuitert	m
Mark Uytterhoeven	m
Mark de Vries	m
Mark van Bommel	m
Mark van den Wijngaert	m
Marko	m
Markos	m
Markovic	m
Markus	m
Markwell	m
Markwin	m
Marla	f
Marlborough	m
Marlee	f
Marleen	f
Marleen Vanderpoorten	f
Marleen Veldhuis	f
Marlein	f
Marlena	f
Marlene	f
Marley	m
Marli	f
Marlie	f
Marlies	f
Marlin	f
Marlinde	f
Marlise	f
Marliz	f
Marlo	m
Marloes	f
Marlon	m
Marlou	f
Marlous	f
Marly	f
Marlyne	f
Marlène	f
Marléne	f
Marmouch	m
Marnie	f
Marnix	m
Marnix Gijsen	m
Maroesja	f
Maroeska	f
Marokkaan	m
Marokkaanse	f
Maronier	m
Marouane Fellaini	m
Marpessa	f
Marquez	m
Marrit	f
Marriët	f
Marry	f
Marsh	m
Marsha	f
Marshall	m
Marshalleilander	m
Marshalleilandse	f
Marston	m
Mart	m
Marta	f
Marte	f
Martel	m
Marten	m
Marten Eikelboom	m
Marten Fortuyn	m
Martha	f
Martha Stewart	f
Marthaler	m
Marthe	f
Marthijn	m
Marthinus	m
Marthy	f
Martie	f
Martien	m
Martijn	m
Martijne	f
Martin	m
Martin Jol	m
Martin Luther King	m
Martin Scorsese	m
Martin Verkerk	m
Martina	f
Martina Hingis	f
Martine	f
Martine Jonckheere	f
Martini	f
Martinikaan	m
Martinikaanse	f
Martino	m
Martinson	m
Martinus	m
Marty	m
Martyn	m
Martínez	m
Maruja	f
Maruschka	f
Maruska	f
Marvano	m
Marvin	m
Marwan	m
Marx	m
Mary	f
Mary Black	f
Mary Dresselhuys	f
Mary Jane	f
Maryam	f
Maryan	f
Maryann	f
Marylin	f
Maryse	f
Maréchal	m
María	f
Mas	m
Masako	f
Mascha	f
Maschinka	f
Masha	f
Masja	f
Mason	m
Massa	m
Massimiliano	m
Massimo	m
Masson	m
Massú	m
Masterman	m
Mat	m
Mat Herben	m
Matea	f
Mateja	m
Mateja Kezman	m
Mateo	m
Materazzi	m
Mateusz	m
Matheas	m
Matheus	m
Mathew	m
Mathias	m
Mathieu	m
Mathieu Criquielion	m
Mathieu Fonteyn	m
Mathijs	m
Mathijsen	m
Mathijssen	m
Mathilde	f
Mathis	m
Mathé	m
Matias	m
Matija	m
Matijs	m
Matilde	f
Matin	m
Matisse	m
Mats	m
Matt	m
Matt Damon	m
Mattan	m
Mattatias	m
Matteo	m
Matteüs	m
Mattheus	m
Matthew	m
Matthews	m
Matthias	m
Matthieu	m
Matthijs	m
Matthys	m
Matthäus	m
Matthé	m
Matti	m
Mattia	m
Mattias	m
Mattie	f
Mattijn	m
Mattijs	m
Matton	m
Matty	f
Matumona	m
Maud	f
Maudy	f
Maufroy	m
Mauk	m
Maup	m
Maura	f
Maura Van Lommel	f
Maureen	f
Mauresmo	f
Maurice	m
Maurice Béjart	m
Maurice De Wilde	m
Maurice Engelen	m
Maurice Greene	m
Maurice White	m
Mauricio	m
Mauritanische	f
Mauritaniër	m
Mauritiaan	m
Mauritiaanse	f
Mauritius	m
Maurits	m
Maurits De Prins	m
Mauritz	m
Maurizio	m
Mauro	m
Maury	f
Mavis	f
Max	m
Maxentius	m
Maxim	m
Maxima	f
Maxime	f
Maximiliaan	m
Maximilian	m
Maximiliano	m
Maximilien	m
Maximillian	m
Maximo	m
Maximus	m
Maxine	f
Maxwell	m
May	f
Maya	f
Mayer	m
Mayim	f
Mayo	m
Maystadt	m
Mazarine	f
Mbark Boussoufa	m
Mbeki	m
Mbenga	m
Mbo Mpenza	m
Mbokani	m
Mbonabucya	m
Mbongo	m
Mc Cain	m
McCain	m
McCall	m
McCarthy	m
McCartney	m
McCauley	m
McClellan	m
McClernand	m
McDowell	m
McEnroe	m
McEwen	m
McLean	m
McMahon	m
McNamara	m
McQueen	m
McRae	m
Meade	m
Meaghan	f
Mechteld	f
Mechtild	f
Meciar	m
Medard	m
Medea	f
Medina	f
Medvedev	m
Medy	f
Meera	f
Meersschaut	m
Meert	m
Meerten	m
Mees	m
Meester	m
Meeter	m
Meeus	m
Meeuwis	m
Meg	f
Megan	f
Megawati	f
Meghan	f
Mehdi	m
Mehmed	m
Mehmet	m
Mehti	m
Mei	f
Meia	f
Meijer	m
Meijs	f
Meike	f
Meilof	m
Meindert	m
Meine	m
Meinhard	m
Meinsje	f
Meint	m
Meirhaeghe	m
Meis	f
Meiwes	m
Meja	f
Mekkaan	m
Mekkaanse	f
Mel	m
Mel Brooks	m
Mela	f
Melanesische	f
Melanesiër	m
Melanie	f
Melchers	f
Melchior	m
Melexis	m
Melia	f
Melih	m
Melika	f
Melina	f
Melinda	f
Melis
Melisa	f
Melissa	f
Melita	f
Melkert	m
Melle	m
Mellemans	m
Melline	f
Melody	f
Melonie	f
Mels	m
Melveren	m
Melvin	m
Melvyn	m
Memnon	m
Memphis	m
Mena	f
Menchov	m
Mende	f
Mendel	m
Mendelssohn	m
Mendes	m
Mendibj	m
Mendieta	f
Mendoza	m
Menelaüs	m
Menem	m
Mengelberg	m
Menke	f
Menno	m
Menotti	m
Mensje	f
Menso	m
Menzo	m
Mer	m
Meral	f
Mercader	m
Mercan	f
Mercedes	f
Merckx	m
Mercury	m
Meredith	f
Merel	f
Meret	f
Meri	f
Merijn	m
Merkel	f
Merlier	m
Merlijn	m
Mertens	m
Mervyn	m
Merwin	m
Meryl	f
Meryl Streep	f
Mesa	m
Mesopotamische	f
Mesopotamiër	m
Messi	m
Messias	m
Messner	m
Messoudi	m
Mestdag	m
Mestrallet	m
Mesut	m
Meta	f
Meta Knight	m
Metcalfe	m
Meteors	m
Metformine	m
Methusalem	m
Metin	m
Metje	f
Metris	m
Mette	f
Metten	m
Meulenaere	m
Meurs	m
Meus	m
Mevlüt	m
Mewis	m
Mexicaan	m
Mexicaanse	f
Meyer	m
Meys
Mi	f
Mia	f
Mia Audina	f
Mica	m
Micaela	f
Micah	m
Micha	m
Michael	m
Michael Boogerd	m
Michael Coenen	m
Michael Douglas	m
Michael J. Fox	m
Michael Jackson	m
Michael Jordan	m
Michael Mann	m
Michael Mols	m
Michael Moore	m
Michael Nnaji	m
Michael Phelps	m
Michael Rasmussen	m
Michael Schumacher	m
Michaela	f
Michaelangelo	m
Michaels	m
Michail	m
Michail Gorbatsjov	m
Michal	f
Michalis	m
Michaël	m
Michaëla	f
Michaëlla	f
Michaëlla Krajicek	f
Michaïl	m
Micheal	m
Michel	m
Michel D'Hooghe	m
Michel Daerden	m
Michel Follet	m
Michel Fourniret	m
Michel Preud'homme	m
Michel Van Hauve	m
Michela	f
Michelangelo	m
Michele	m
Micheline	f
Michell	m
Michelle	f
Michelle Martin	f
Michels	m
Michiel	m
Michiels	m
Michielsen	m
Michiko	f
Michon	m
Michou	f
Michèle	f
Michéle	f
Mick	m
Mick Jagger	m
Mickael	m
Micke	m
Mickelson	m
Mickey	m
Mickey Rourke	m
Micronesische	f
Micronesiër	m
Midas	m
Middelburger	m
Middelburgse	f
Mido	m
Miek	f
Miek Vyncke	f
Mieke	f
Mieke Vogels	f
Miel	m
Mien	f
Mieneke	f
Mient	m
Mientje	f
Miep	f
Mies	f
Mieszko	m
Miet Smet	f
Miettunen	m
Mignolet	m
Mignon	f
Miguel	m
Mihajlo	m
Mihály	m
Mijke	f
Mijndert	m
Mijnie	f
Mijntje	f
Mijs	f
Mik	m
Mika	m
Mikael	m
Mikal	m
Mikaël	m
Mike	m
Mikel	m
Mikey	m
Mikhail	m
Mikis	m
Mikkel	m
Mikki	f
Mikko	m
Miklos	m
Miklós	m
Miko	m
Mila	f
Milagros	f
Milan	m
Milanees	m
Milanese	f
Milano	m
Milco	m
Mildred	f
Milena	f
Milene	f
Milenko	m
Milenkovic	m
Miles	m
Miles Davis	m
Miley	f
Milko	m
Milla	f
Millar	m
Miller	m
Mills	m
Milly	f
Milne	m
Milo	m
Milorad	m
Milos	m
Milosevic	m
Milosovic	m
Milou	f
Miloud	m
Miloš	m
Milquet	f
Milroy	m
Milstein	m
Milton	m
Mimi	f
Mimoun	m
Mimount	f
Mina	f
Minco	m
Mineiro	m
Minette	f
Ming	m
Mink	m
Minka	f
Minke	f
Minnaert	m
Minne	m
Minny	f
Mino	m
Minogue	f
Minos	m
Minze	m
Miquel	m
Mir	m
Mira	f
Mirabeau	m
Miranda	f
Mirco	m
Mireille	f
Mirela	f
Mirella	f
Mireya	f
Miriam	f
Mirjam	f
Mirjan	f
Mirjana	f
Mirka	f
Mirko	m
Mirna	f
Miro	m
Miroslav	m
Miroslav Klose	m
Mirsad	m
Miryam	f
Mirza	m
Miró	m
Mischa	m
Misha	m
Misja	m
Misty	f
Mitch	m
Mitchel	m
Mitchell	m
Mithridates	m
Mitt Romney	m
Mittal Steel	m
Mitterand	m
Mitterrand	m
Mittler	m
Mittni	m
Mitu	m
Mladen	m
Mladic	m
Mme de Staël	f
Mnouchkine	f
Mo	m
Mo Markai	m
Mo'é'ha'e	f
Moab	m
Moberg	m
Mobutu	m
Moby	m
Modigliani	m
Modrikamen	m
Moeder Aarde	f
Moenaert	m
Moens	m
Moerman	f
Moesa	m
Moestafa	m
Moggi	m
Mogh	m
Mogilevitsj	m
Mohamad	m
Mohamed	m
Mohammad	m
Mohammed	m
Mohammed B.	m
Mohsen	m
Moi	m
Moisiu	m
Mokhtar	m
Mol	m
Moldavische	f
Moldaviër	m
Moleveld	m
Molina	m
Molière	m
Moll	m
Molly	f
Molotov	m
Mols	m
Molukker	m
Molukse	f
Momo	f
Mona	f
Monaghan	m
Mondriaan	m
Monegask	m
Monegaskische	f
Monet	m
Mongolische	f
Mongoliër	m
Moni	f
Monic	f
Monica	f
Moniek	f
Monika	f
Monique	f
Monk	m
Monne	m
Monroe	f
Monroviaan	m
Monroviaanse	f
Monte	m
Monte Cristo	m
Montenegrijn	m
Montenegrijnse	f
Montesquieu	m
Montevideaan	m
Montevideaanse	f
Monteyne	m
Montgomery	m
Monti	m
Montoya	m
Montserrat	f
Montserrataan	m
Montserrataanse	f
Moon	f
Moor
Moore	m
Moqtada	m
Morad	m
Morales	m
Moravische	f
Moraviër	m
Mordasjov	m
Mordechai	m
More	m
Moreau	m
Moreels	m
Morena	f
Moreno	m
Morgan
Morgane	f
Morgoth	m
Moriau	m
Morillon	m
Moritz	m
Morley	m
Morren	m
Morris
Morris Tabaksblat	m
Morrison	m
Morrissey	m
Morsa	m
Mortelmans	m
Morten	m
Mortier	m
Mos	m
Moses	m
Moshe	m
Moskouer	m
Moskouse	f
Mosley	m
Moss	f
Mossi	m
Mostovoj	m
Moszkowicz	m
Motta	m
Moulay	m
Moulin	m
Mounir	m
Mourad	m
Mourinho	m
Mousa	m
Mousavi	m
Moussa	m
Moussa Dembele	m
Moussaoui	m
Moya
Moya	m
Mozambikaan	m
Mozambikaanse	f
Mozart	m
Mozes	m
Moïse	f
Mpenza	m
Mr. Silvera	m
Mrdja	m
Mubarak	m
Mueller	m
Mugabe	m
Muhamed	m
Muhamet	m
Muhammad	m
Muhammed	m
Muhammet	m
Muharem	m
Muharrem	m
Muhsin	m
Mulder	m
Mulders	m
Mulemo	m
Mulisch	m
Muller	m
Mulligan	m
Multatuli	m
Munch	m
Munir	m
Muqtada al-Sadr	m
Murad	m
Murakami	m
Murat	m
Murat D.	m
Murdoch	m
Muriel	f
Muriël	f
Murk	m
Murney	m
Murphy	m
Murray	m
Musa	m
Museeuw	m
Museveni	m
Musharraf	m
Muslin	m
Mussert	m
Mussolini	m
Mustafa	m
Mustafa Kemal	m
Mustapha	m
Muus	m
Muyshond	m
Myanmarees	m
Myanmarese	f
Myers	m
Mylene	f
Myles	m
Mylène	f
Mylène d'Anjou	f
Myra	f
Myriam	f
Myrna	f
Myron	m
Myrthe	f
Mysterio	m
Mystique	f
Mátyás	m
Máxima	f
Mäkinen	m
Mélissa	f
Méndez	m
Mérimée	m
Möllemann	m
Möller	m
Möring	m
Müller	m
Naamse	f
Nabal	m
Nabiha	f
Nabil	m
Nabila	f
Nabokov	m
Naciye	f
Nada	f
Nadal	m
Nader	m
Nadia	f
Nadine	f
Nadir	m
Nadire	f
Nadiya	f
Nadj	m
Nadja	f
Nadjezjda	f
Nadjiboellah	m
Nadya	f
Naeem	m
Naema	f
Naftali	m
Naim	m
Naima	f
Naina	f
Naipaul	m
Najat	f
Naji	m
Najib	m
Najim El Boudani	m
Najla	f
Najlae	f
Najoua	f
Najwa	f
Nakamura	m
Nakano	m
Nakire	m
Namenaar	m
Namibische	f
Namibiër	m
Nan	m
Nana	f
Nance	f
Nancy	f
Nancy Astor	f
Nand	m
Nanda	f
Nando	m
Nandor	m
Nanette	f
Nani	f
Nanine	f
Nanne	m
Nannet	f
Nanni	f
Nannie	f
Nano	m
Nanouk	f
Naomi	f
Naomi Campbell	f
Naomie	f
Napoleon	m
Napoleon Bonaparte	m
Napoleon I	m
Napoleon III	m
Napolitaan	m
Napolitaanse	f
Narcissus	m
Nas	m
Nash	m
Nasir	m
Nasr	m
Nasrallah	m
Nasrin	f
Nassauer	m
Nassause	f
Nasser	m
Natalia	f
Natalie	f
Natalja	f
Natan	m
Natanaël	m
Natanya	f
Natascha	f
Natascha Kampusch	f
Natasha	f
Natasja	f
Nataša	f
Nate	m
Nathalia	f
Nathalie	f
Nathalie De Vos	f
Nathan	m
Nathanael	m
Nathaniel	m
Nauruaan	m
Nauruaanse	f
Nauwynck	m
Navarro	m
Navin	m
Navratilova	f
Nawal	f
Nawijn	m
Nawshirwan	m
Naya	f
Nayan	m
Nazareense	f
Nazareeër	m
Naïma	f
Neal	m
Neanderthaler
Nebahat	f
Nechelput	m
Necmettin	m
Neder-Oostenrijker	m
Nederlander	m
Nederlandse	f
Nederlandstalige
Nedim	m
Neefs	m
Neelie	f
Neelie Kroes	f
Neels	m
Neeltje	f
Neeskens	m
Nehemia	m
Nehru	m
Neijhorst	m
Neil	m
Neil Armstrong	m
Neil Kinnock	m
Neil Young	m
Nel	f
Nele	f
Nelis	m
Nelissen	m
Nelleke	f
Nelli	f
Nellie	f
Nello	m
Nelly	f
Nelson	m
Nelson Mandela	m
Nemo	m
Nenad	m
Neneh	f
Neo	m
Nepalees	m
Nepalese	f
Nequam	m
Nero	m
Nescio	m
Nesta	m
Nestor	m
Nestorius	m
Netanjahoe	m
Netanyahu	m
Netelenbos	f
Nettie	f
Netty	f
Neurenberger	m
Neurenbergse	f
Nevada	f
Neve	f
Nevil	m
Nevill	m
Neville	m
Nevin	f
Newman	m
Newton	m
Ney	m
Neyens	m
Ni	f
Niall	m
Niamh	f
Nibali	m
Nic	m
Nicaise	m
Nicaraguaan	m
Nicaraguaanse	f
Nicci	f
Niccolò Machiavelli	m
Nicholas	m
Nicholson	m
Nick	m
Nick Faldo	m
Nick Nuyens	m
Nick Van Der Westerlaken	m
Nicki	f
Nicklas	m
Nicklaus	m
Nicky	m
Niclas	m
Nico	m
Nico Claesen	m
Nico Eeckhout	m
Nico Mattan	m
Nico Rosberg	m
Nico Van Kerckhoven	m
Nico Verhoeven	m
Nicodemus	m
Nicola	f
Nicolaas	m
Nicolaas II	m
Nicolae	m
Nicolai	m
Nicolaj	m
Nicolas	m
Nicolas Cage	m
Nicolas Colsaerts	m
Nicolas Frutos	m
Nicolas Sarkozy	m
Nicolas Vereecken	m
Nicolaus	m
Nicolay	m
Nicolaï	m
Nicole	f
Nicole Kidman	f
Nicoletta	f
Nicolette	f
Nicolien	f
Nicoline	f
Nicolle	f
Nicolás	m
Niehe	m
Niek	m
Niel	m
Niels	m
Niels Albert	m
Niels Olsen	m
Niels Vandyck	m
Nielsen	m
Nienke	f
Nietzsche	m
Nieuw-Caledonische	f
Nieuw-Caledoniër	m
Nieuw-Guinese	f
Nieuw-Guineër	m
Nieuw-Zeelander	m
Nieuw-Zeelandse	f
Nigel	m
Nigel Williams	m
Nigella	f
Nigeraan	m
Nigeraanse	f
Nigeriaan	m
Nigeriaanse	f
Nihoul	m
Nijboer	m
Nijenhuis	m
Nijmeegse	f
Nijmegenaar	m
Nijpels	m
Nijsingh	m
Nikanor	m
Nike	f
Niki	f
Nikita	f
Nikki	f
Nikkie	f
Niklaas	m
Niklas	m
Niko	m
Niko Eeckhout	m
Nikola	m
Nikolaas	m
Nikolai	m
Nikolaj	m
Nikolaj Mjaskovski	m
Nikolaos	m
Nikolaus	m
Nikolic	m
Nikos	m
Nilgün	f
Nilis	m
Nilo	m
Nils	m
Nils Duerinck	m
Nilsson	m
Nimrod	m
Nina	f
Nina Brink	f
Nine	f
Ninette	f
Nini	f
Nino	m
Niny	f
Nirmala	f
Nita	f
Nitin	m
Nivea	m
Niven	m
Nixon	m
Niyazi	m
Niyi	m
Nizar	m
Nkunda	m
Noa	f
Noach	m
Noah	m
Noam	m
Nobelprijswinnaar
Noel	m
Noelle	f
Nol	m
Nola	f
Nolan	m
Nolf	m
Nolke	m
Nols	m
Nong	m
Noor	f
Noord	m
Noord-Afrikaan
Noord-Amerikaan	m
Noord-Amerikaanse	f
Noord-Brabander	m
Noord-Brabantse	f
Noord-Hollander	m
Noord-Hollandse	f
Noord-Ier	m
Noord-Ierse	f
Noord-Koreaan	m
Noord-Koreaanse	f
Noorman	m
Noorse	f
Noortje	f
Nora	f
Norah	f
Noraly	f
Norbert	m
Nordholt	m
Nordin	m
Nordine	m
Noreen	f
Norma	f
Norman	m
Normandische	f
Normandiër	m
North	m
Norton	m
Norvell	m
Noud	m
Noura	f
Nourdin	m
Nourdine	m
Noureddine	m
Nouri	m
Nout	m
Novak	m
Nowotny	m
Nowé	m
Noë
Noël	m
Nuala	f
Nubische	f
Nubiër	m
Numan	m
Nuno	m
Nur	f
Nura	f
Nuray	f
Nuriye	f
Nurmi	m
Nuyens	m
Nuyts	m
Nynke	f
Nys	m
Nével	f
O'Brien	m
O'Grady	m
O'Leary	m
O'Neill	m
O'Shaunessy	m
O'Sullivan	m
OLV	f
Obadja	m
Obama	m
Obasanjo	m
Obbe	m
Obe	m
Oberon	m
Obi-Wan Kenobi	m
Obiora	m
Obregón	m
Obrenović	m
Ocker	m
Octave	m
Octavianus	m
Oda	f
Odette	f
Odile	f
Odin	m
Odo	m
Odysseus	m
Oebele	m
Oedai	m
Oedipus	m
Oek	m
Oekraïense	f
Oekraïner	m
Oene	m
Oepke	m
Oerlemans	m
Oezbeek	m
Oezbeekse	f
Ogunjimi	m
Ogunsoto	m
Oguz	m
Okan	m
Okapi	m
Okapi Aalstar	m
Okello	m
Okke	m
Okolnit	m
Oksana	f
Okunowo	m
Ola	f
Olaf	m
Olav	m
Olchert	m
Olcott	m
Ole	m
Oleg	m
Oleguer	m
Olga	f
Olga Kamyshleeva	f
Olger	m
Oliseh	m
Oliver	m
Oliver Kahn	m
Olivia	f
Olivier	m
Olivier Denoyelle	m
Olivier Rochus	m
Olle	m
Ollie	m
Olly	m
Olmert	m
Olof	m
Olsen	m
Olsson	m
Oltmans	m
Olufade	m
Olyslaegers	m
Omaanse	f
Omani	m
Omar	m
Omara	f
Omer	m
Omid	m
Omri	m
Onassis	m
Onkelinx	f
Onnes	m
Onno	m
Ono	m
Onyewu	m
Onze Lieve Heer	m
Onze Royale Hoogheid	m
Onze-Lieve-Heer	m
Onze-Lieve-Vrouw	f
Ooijer	m
Ooms	m
Oost-Fries	m
Oost-Vlaamse	f
Oost-Vlaming	m
Oostenrijker	m
Oostenrijkse	f
Oosterhoff	m
Oosting	m
Op de Beeck	m
Opbrouck	m
Opdam	m
Open Vld	f
Oppenheimer	m
Opper-Oostenrijker	m
Oprah	f
Oprah Winfrey	f
Opstelten	m
Option	m
Oral	m
Oranje
Oranje-Vrijstater	m
Oranjestadse	f
Oranjestatter	m
Oranjesupporter
Oreste Nava	m
Orestes	m
Orhan	m
Oriana	f
Oric	m
Origenes	m
Oriol	m
Orkun	m
Orlando	m
Orly	f
Orochimaru	m
Orson	m
Ortega	m
Ortiz	m
Orton	m
Orville	m
Orwell	m
Osama	m
Osama Bin Laden	m
Osama bin Laden	m
Oscar	m
Oscar Freire	m
Oscar Mathisen	m
Oscar Wilde	m
Osei	m
Oskar	m
Oskar Schindler	m
Oslose	f
Osloër	m
Osman	m
Osmond	m
Ossip	m
Osvaldo	m
Oswald	m
Oswaldo	m
Othello	m
Othman	m
Othmar	m
Otilia	f
Otis	m
Otje	f
Otmar	m
Ottawaan	m
Ottawaanse	f
Otte	m
Otten	m
Otto	m
Otto Frank	m
Otto I	m
Ottolien	f
Ottoline	f
Ouali	m
Oud	m
Oud-Heverlee Leuven	m
Oudkerk	m
Oudolf	m
Ould Haj	m
Oulmers	m
Oumou	f
Ousama	m
Ousmane	m
Oussama	m
Out	m
Ovcina	m
Ove	m
Overijsselaar	m
Overijsselse	f
Overmars	m
Ovetsjkin	m
Ovide	m
Owen	m
Oxaco	m
Oxana	f
Oyen	m
Ozai	m
Ozan	m
Ozlem	f
Ozzy	m
P!nk	f
P.J.H. Cuypers	m
P.W. Botha	m
Paasikivi	m
Paauwe	m
Pablo	m
Pacino	m
Packer	m
Paco	m
Paduaan	m
Paduaanse	f
Pagano	m
Page	m
Paige	f
Paisley	m
Pakistaan	m
Pakistaanse	f
Paksas	m
Palestijn	m
Palestijnse	f
Palin	f
Palladio	m
Pallas	m
Palm	m
Palma	f
Palmen	f
Palmer	m
Palmyre	f
Paltrow	f
Pam	f
Pamela	f
Pamela Anderson	f
Pamuk	m
Panamarenko	m
Panamees	m
Panamese	f
Pancho	m
Pancho Villa	m
Pander	m
Pandy	m
Pannekoek	m
Pans	m
Pantani	m
Paola	f
Paolo	m
Paolo Bettini	m
Paolo Maldini	m
Paolo Savoldelli	m
Papadopoulos	m
Papandreou	m
Papy	m
Paracelsus	m
Paraguayaan	m
Paraguayaanse	f
Paramaribose	f
Paramariboër	m
Paravizzini	m
Pareja	m
Parijse	f
Parijzenaar	m
Paris	f
Paris Hilton	f
Park	m
Parker	m
Parks	m
Parr	m
Parreira	m
Pasanen	m
Pascal	m
Pascal Colaert	m
Pascal Smet	m
Pascal Vanelslander	m
Pascale	f
Pascalle	f
Pascha	f
Paskal	m
Pasmans	m
Pasquale	m
Pastore	m
Pastors	m
Pat	f
Patagonische	f
Patagoniër	m
Patch	m
Pater Magnani	m
Paternoster	m
Patijn	m
Patric	m
Patrice	m
Patricia	f
Patricio	m
Patrick	m
Patrick Dewael	m
Patrick Goots	m
Patrick Haemers	m
Patrick Janssens	m
Patrick Kluivert	m
Patrick Lefevere	m
Patrick Paauwe	m
Patrick Riguelle	m
Patrick Tillieux	m
Patrick Vangheluwe	m
Patrick Vieira	m
Patrik	m
Patrizia	f
Patrizio	m
Patsy	f
Patten	m
Patterson	m
Patti	f
Patti Smith	f
Patton	m
Patty	f
Patty Scholten	f
Paul	m
Paul Auster	m
Paul Bosvelt	m
Paul D'Hoore	m
Paul Delvaux	m
Paul Gauguin	m
Paul Haarhuis	m
Paul Jambers	m
Paul Koek	m
Paul Marchal	m
Paul McCartney	m
Paul Put	m
Paul Rosenmöller	m
Paul Scheffer	m
Paul Scholes	m
Paul Severs	m
Paul Simon	m
Paul Smith	m
Paul Tergat	m
Paul Van Grembergen	m
Paul Van Himst	m
Paul Van Nevel	m
Paul Vanden Boeynants	m
Paul Verhoeven	m
Paul Verlaine	m
Paul de Leeuw	m
Paul van Buitenen	m
Paula	f
Paula Bangels	f
Paulette	f
Pauli	m
Paulien	f
Paulina	f
Pauline	f
Paulinus	m
Paulissen	m
Paulo	m
Paulson	m
Paulus	m
Pauw	m
Pauwel	m
Pauwels	m
Pavel	m
Pavle	m
Pavlos	m
Pavlovic	m
Pawel	m
Peanuts	m
Pearl	f
Pearson	m
Peasmi	f
Pechtold	m
Peder	m
Pedersen	m
Pedrito	m
Pedro	m
Peelse	f
Peer	m
Peerke	m
Peet	m
Peeter	m
Peetje	f
Peggy	f
Pei	f
Peijs	f
Peiper	m
Peirsol	m
Pekinees	m
Pekinese	f
Pekinger	m
Pelayo	m
Pelckmans	m
Pelenaar	m
Pelle	m
Pellegrini	m
Pellicano	m
Pellè	m
Pelé	m
Pemberton	m
Penelope	f
Peng	m
Penn	m
Penny	f
PeopleSoft	m
Pep	m
Pepe	m
Peper	m
Pepijn	m
Pepper	f
Per	m
Per Nørgård	m
Perceval	m
Percival	m
Percy	m
Perduellis	m
Perea	m
Pereira	m
Pereiro	m
Perelman	m
Peres	m
Perez	m
Perijn	m
Perisic	m
Perkins	m
Permeke	m
Pernilla	f
Perridon	m
Perrot	m
Perry	m
Pers	m
Persoons	m
Persson	m
Peruaan	m
Peruaanse	f
Perzische	f
Perón	m
Pessoa	m
Peta	f
Petacchi	m
Petar	m
Pete	m
Pete Sampras	m
Petegem	m
Peter	m
Peter Baert	m
Peter Carmeliet	m
Peter Crouch	m
Peter Hoekstra	m
Peter Hoogland	m
Peter Jackson	m
Peter Maes	m
Peter Osmond	m
Peter R. de Vries	m
Peter Smolders	m
Peter Van Houdt	m
Peter Van Petegem	m
Peter Van de Veire	m
Peter Vanvelthoven	m
Peter de Grote	m
Peter van Vossen	m
Peters	m
Petersen	m
Peterson	m
Petr	m
Petr Krajicek	m
Petra	f
Petrarca	m
Petri	f
Petro	m
PetroFina	m
Petronella	f
Petronius	m
Petrova	f
Petrovic	m
Petrus	m
Petter	m
Peyton	f
Pfaff	m
Pfeiffer	f
Phara	f
Phelps	m
Phil	m
Phil Collins	m
Phil Taylor	m
Phileine	f
Philibert	m
Philip	m
Philip Akkerman	m
Philip Dewinter	m
Philip Roth	m
Philipine	f
Philipp	m
Philippa	f
Philippaerts	m
Philippe	m
Philippe Bodson	m
Philippe Clement	m
Philippe De Coene	m
Philippe Gilbert	m
Philippe Herreweghe	m
Philippe Léonard	m
Philippe Moureaux	m
Philippe Saint-Jean	m
Philippos	m
Philippoussis	m
Philippus	m
Philips	m
Phillip	m
Phillip Cocu	m
Phillipe	m
Phillips	m
Philo	f
Philomena	f
Phineas	m
Phoebe	f
Phoenix	m
Phonak	m
Phraates	m
Phyllis	f
Pia	f
Piaget	m
Picanol	m
Picardische	f
Picardiër	m
Picasso	m
Pickford	f
Picot	m
Picqueur	m
Pidy	m
Piebe	m
Pien	f
Pienaar	m
Pieper	m
Pier	m
Pierre	m
Pierre Chevalier	m
Pierre Wynants	m
Pierre van der Mersch	m
Pierson	m
Pierucci	m
Piet	m
Piet Borst	m
Piet Goddaer	m
Piet Huysentruyt	m
Piet Retief	m
Pieta	f
Pieter	m
Pieter Aspe	m
Pieter Collen	m
Pieter De Crem	m
Pieter Desmet	m
Pieter Ghyllebert	m
Pieter Gysel	m
Pieter Jacobs	m
Pieter Loridon	m
Pieter Merlier	m
Pieter Steinz	m
Pieter Tsjoen	m
Pieter Vries	m
Pieter de Hooch	m
Pieter van den Hoogenband	m
Pieterjan	m
Pieterman	m
Pieternel	f
Pieters	m
Pietersen	m
Pietje
Pietro	m
Pijl	m
Pijpers	m
Pilar	f
Pilatus	m
Pilou	f
Pim	m
Pim Fortuyn	m
Pim Verbeek	m
Pina	f
Pina Bausch	f
Pinar	f
Pindarus	m
Pink	f
Pino	m
Pinochet	m
Pinter	m
Pinxten	m
Piotr	m
Pipo	m
Pippa	f
Pira	f
Piranesi	m
Pirard	m
Pires	f
Pirk	m
Piryns	f
Piso	m
Pistorius	m
Pitcairneilander	m
Pitcairneilandse	f
Pitt	m
Pitzemburg	m
Pius	m
Pius IX	m
Pius XI	m
Pius XII	m
Pivaljevic	m
Pizarro	m
Pizzi	m
Pjotr	m
Planckaert	m
Planckendael	m
Plankzeiler Joeri van Dijk	m
Plath	f
Platini	m
Plato	m
Platteau	m
Platvoet	m
Plautia	f
Plaza	m
Plesman	m
Pleun	f
Pleuni	f
Plien	f
Plonia	f
Plooy	m
Plop	m
Plotinus	m
Pocognoli	m
Poetin	m
Pol	m
Pol Pot	m
Polak	m
Polanski	m
Polina	f
Poll	m
Pollock	m
Polly	f
Polo	m
Polynesische	f
Polynesiër	m
Pommer	m
Pompeius	m
Pomponia	f
Poncelet	m
Pontiac	f
Pool	m
Poolse	f
Poot	m
Pope	m
Popeye	m
Popovych	m
Poppe	m
Popper	m
Poppo	m
Porsius	m
Porter	m
Portia	f
Portillo	m
Portugees	m
Portugese	f
Porus	m
Poseidon	m
Postell	m
Postma	m
Potgieter	m
Poul	m
Pound	m
Powell	m
Power	m
Pozzato	m
Praagse	f
Praet	m
Prager	m
Pratt	m
Precious	f
Predrag	m
Prem	m
Prenen	f
Prescott	m
Presser	m
Preston	m
Pretoriaan	m
Pretoriaanse	f
Preud'homme	m
Prešeren	m
Price	m
Prien	m
Priestley	m
Primo	m
Prince	m
Princess	f
Prinsen	m
Priscilla	f
Prodi	m
Profumo	m
Prokofjev	m
Pronk	m
Prosper	m
Prospero	m
Proto	m
Proudhon	m
Provenzano	m
Prue	f
Pruis	m
Pruisische	f
Ptolemaeus	m
Puccini	m
Puck	f
Puddu	m
Puertoricaan	m
Puertoricaanse	f
Pujol	m
Punt	m
Puratos	m
Purdy	f
Put	m
Putnam	m
Putswe	m
Puyol	m
Pyatov	m
Pyke	m
Pyrrhus	m
Pythagoras	m
Páez	m
Pérez	m
Pétain	m
Péter	m
Q-music	m
Qadhafi	m
Qatarees	m
Qatarese	f
Quack	m
Quaden	m
Quaid	m
Quantrill	m
Queen	f
Queenie	f
Quentin	m
Quentin Tarantino	m
Querido	m
Quido	m
Quincy	m
Quine	m
Quinn	m
Quint	m
Quinten	m
Quintus	m
Quinty	f
Quique	m
Quirijn	m
Quiteen	m
Quiteense	f
Raaf	m
Raas	m
Rabelais	m
Rabiaa	f
Rabin	m
Rabus	m
Rachad	m
Rachael	f
Rachel	f
Rachele	f
Racheli	f
Rachelle	f
Rachid	m
Rachida	f
Rachmaninov	m
Radboud	m
Radcliffe	f
Rademakers	m
Radha	f
Radi	m
Radini	m
Radovan Karadzic	m
Radu	m
Radwan	m
Radzinski	m
Raemon	m
Raemon Sluiter	m
Raes	m
Raf	m
Raf Coppens	m
Raf Simons	m
Rafa	m
Rafael	m
Rafael Nadal	m
Rafael van der Vaart	m
Rafaël	m
Raffaele	m
Raffaella	f
Raffarin	m
Rafi	m
Rafik	m
Rafiq	m
Ragnar	m
Rahim	m
Rahma	f
Rahman	m
Rahul	m
Raich	m
Raikkonen	m
Raily	m
Raimon	m
Raimond	m
Raimondo	m
Rainer	m
Rainier	m
Raisa	f
Raj	m
Raja	f
Rajan	m
Rajiv	m
Rajko	m
Rajkumar	m
Raju	m
Rakesh	m
Ralf	m
Ralf Schumacher	m
Ralph	m
Ralph Lauren	m
Ralph Vaughan Williams	m
Ram
Ramadan	m
Raman	m
Ramaphosa	m
Ramazan	m
Ramdas	m
Ramesh	m
Rami	m
Ramiro	m
Ramiz	m
Rammant	m
Ramon	m
Ramona	f
Ramos	m
Ramses	m
Ramsey	m
Ramsey Nasr	m
Ramzi	m
Ramón	m
Rana	f
Ranco	m
Randal	m
Randall	m
Randi	f
Randolph	m
Randy	m
Rangooner	m
Rangoonse	f
Rani	f
Rani De Coninck	f
Rania	f
Ranko	m
Ranomi	f
Raouf	m
Raoul	m
Raoul Peeters	m
Rapaic	m
Raph	m
Raphael	m
Raphaël	m
Raphaëlle	f
Rapid	m
Rapid Leest	m
Raquel	f
Rascha	f
Rasheed	m
Rashid	m
Rashied	m
Rasmus	m
Rasmussen	m
Ratchet	m
Ratelband	m
Rauf	m
Rauke	m
Raul	m
Raul Castro	m
Rauter	m
Raveel	m
Ravel	m
Raven	m
Ravi	m
Rawie	m
Ray	m
Raya	f
Raymon	m
Raymond	m
Raymond van Barneveld	m
Raymond van het Groenewoud	m
Raymonde	f
Raymund	m
Raymundus	m
Raël	m
Raïsa	f
Raúl	m
Rea	f
Reagan	m
Rebeca	f
Rebecca	f
Rebecca Loos	f
Rebekah	f
Rebekka	f
Rebellin	m
Recep	m
Rechabeam	m
Rechelle	f
Recticel	m
Red
Reding	f
Redmar	m
Redondo	m
Reed	m
Reender	m
Reesink	m
Reeve	m
Reeves	m
Reg	m
Reggie	m
Regi	m
Regilio	m
Regillio	m
Regina	f
Reginald	m
Regine	f
Regnerus	m
Regus	m
Reibestein	m
Reich	m
Reich-Ranicki	m
Reid	m
Reidar	m
Reigerlo Beernem	m
Reijnders	m
Reilly	m
Rein	m
Reina
Reinaldo	m
Reinbert	m
Reind	m
Reinder	m
Reindert	m
Reiner	m
Reinfeldt	m
Reinhard	m
Reinhardt	m
Reinhart	m
Reinhold	m
Reinier	m
Reinoud	m
Reinout	m
Reintje	f
Reiné	m
Reitsma	m
Reiziger	m
Rekha	f
Reks	m
Rem	m
Rembert	m
Rembrandt	m
Remco	m
Remer	m
Remi	m
Remie	m
Remigio	m
Remigius	m
Remke	f
Remkes	m
Remko	m
Remmelt	m
Remmert	m
Remmert Wielinga	m
Remmy	f
Remo	m
Remon	m
Remy	m
Remzi	m
Rena	f
Renald	m
Renard	m
Renata	f
Renate	f
Renate Groenewold	f
Renato	m
Renaud	m
Renders	m
Rendert	m
Rene	m
Renee	f
Renger	m
Renie	f
Renier	m
Renilde	f
Renko	m
Rennenberg	m
Rennie	f
Renno	m
Renny	f
Reno	m
Rens	m
Rense	m
Rensen	m
Renske	f
Renze	m
Renzo	m
René	m
René Trost	m
René Vandereycken	m
Renée	f
Resilux	m
Reuben	m
Reve	m
Rex	m
Rey	m
Reyer	m
Reyes	m
Reykjaviker	m
Reykjavikse	f
Reynaert	m
Reynaldo	m
Reynaud	m
Reynders	m
Reynebeau	m
Reynier	m
Reynolds	m
Reyns	m
Reza	m
Rezi	f
Rhand	m
Rhys	m
Ria	f
Riad	m
Rian	f
Riana	f
Rianne	f
Riaz	m
Ribéry	m
Ric	m
Rica	f
Ricardo	m
Riccardo	m
Ricco	m
Rich	m
Richard	m
Richard Arnell	m
Richard Culek	m
Richard Groenendaal	m
Richard Krajicek	m
Richard Miller	m
Richard Strauss	m
Richard Wagner	m
Richard Williams	m
Richard Witschge	m
Richardson	m
Richelle	f
Richie	m
Richter	m
Ricimer	m
Rick	m
Rick de Leeuw	m
Rick van Velthuyzen	m
Rickey	m
Ricky	m
Rico	m
Ricus	m
Ridder	m
Ridgway	m
Rie	f
Riek	f
Riekje	f
Riekus	m
Riemer	m
Rien	m
Rieneke	f
Rienk	m
Rieno Van Oost	m
Ries	m
Riet	f
Rietje	f
Rifka	f
Rigobert	m
Riis	m
Rijk	m
Rijkaard	m
Rijkman	m
Rijn	m
Rijnders	m
Rijnhard	m
Rijpstra	m
Rik	m
Rik Ceulemans	m
Rik Coolsaet	m
Rik Daems	m
Rik Torfs	m
Rik Verbrugghe	m
Rika	f
Rikash	m
Riki	f
Rikkert	m
Rikki
Rikst	f
Rikus	m
Rilana	f
Riley	m
Rilke	m
Rimailho	m
Rimmer	m
Rina	f
Rinaldo	m
Rinda	f
Rindert	m
Rineke	f
Rinette	f
Ringo	m
Rinie	f
Rink	m
Rinke	m
Rino	m
Rinse	m
Rinske	f
Rinskje	f
Rintje	m
Rinus	m
Rinus Michels	m
Rinze	m
Rio	m
Riordan	m
Ripley	m
Riquelme	m
Ris	f
Risto	m
Ristovic	m
Rita	f
Rita Verdonk	f
Ritchie	m
Ritchie Motke	m
Ritsaert	m
Ritsma	m
Ritter	m
Ritter Algoet	m
Rivaldo	m
River	m
Rivera	m
Rivka	f
Rixt	f
Riëtte	f
Roald	m
Rob	m
Rob Heyvaert	m
Rob Oudkerk	m
Rob Out	m
Rob Peeters	m
Rob Vanoudenhoven	m
Rob de Nijs	m
Robb	m
Robbe	m
Robben	m
Robbert	m
Robbie	m
Robbie McEwen	m
Robbie Williams	m
Robby	m
Robert	m
Robert Brown	m
Robert E. Lee	m
Robert Hunter	m
Robert Jensen	m
Robert Johnson	m
Robert Mugabe	m
Robert Palmer	m
Robert Redford	m
Robert Simpson	m
Roberta	f
Roberto	m
Roberto Baggio	m
Roberto Carlos	m
Roberto Heras	m
Roberts	m
Robertson	m
Robertus	m
Robespierre	m
Robin	m
Robin Hood	m
Robin Korving	m
Robin van Persie	m
Robine	f
Robinho	m
Robinson	m
Robotnik	m
Robrecht	m
Robrecht de Fries	m
Robson	m
Roby	f
Robyn	f
Robèrt	m
Rocco	m
Roche	m
Rochelle	f
Rochus	m
Rock	m
Rockwell	m
Rocky	m
Rocky Peeters	m
Rocus	m
Rocío	f
Rod	m
Roddick	m
Roddy	m
Roderick	m
Roderik	m
Rodin	m
Rodion	m
Rodney	m
Rodolfo	m
Rodolphe	m
Rodrigo	m
Rodriguez	m
Rodríguez	m
Rody	m
Roeder	m
Roef	m
Roefke	f
Roek	m
Roel	m
Roel Derom	m
Roel Paulissen	m
Roel Pieper	m
Roeland	m
Roelandt	m
Roelandts	m
Roelant	m
Roelf	m
Roelfien	f
Roelof	m
Roels	m
Roemeen	m
Roemeense	f
Roemer	m
Rogelio	m
Roger	m
Roger De Clerck	m
Roger Federer	m
Roger Moore	m
Roger Taylor	m
Roger Vanden Stock	m
Rogerio	m
Rogerke	m
Rogers	m
Rogge	m
Rogier	m
Rogiers	m
Roh	m
Rohan	m
Roiha	m
Roj	m
Rokia	f
Rokus	m
Roland	m
Rolando	m
Rolf	m
Rollo	m
Rolph	m
Roma	f
Romain	m
Roman	m
Romana	f
Romand	m
Romano	m
Romano Prodi	m
Romanus	m
Romario	m
Romay	f
Rombout	m
Rombouts	m
Romeijn	m
Romein	m
Romeinse	f
Romelu Lukaku	m
Romeo	m
Romeo Castelen	m
Romero	m
Romeyn	m
Romijn	m
Romke	m
Romme	m
Rommedahl	m
Rommel	m
Rommert	m
Romney	m
Romy	f
Roméo	m
Romøren	m
Ron	m
Ronald	m
Ronald Koeman	m
Ronald Reagan	m
Ronaldinho	m
Ronaldo	m
Ronan	m
Ronen	m
Rong	m
Roni	m
Ronnie	m
Ronnie O'Sullivan	m
Ronny	m
Ronny Mosuse	m
Rony	m
Roodbaard	m
Roodkapje	f
Rooney	m
Roos	f
Roosevelt	m
Roque	m
Rorik	m
Rorty	m
Rory	m
Ros	m
Rosa	f
Rosales	m
Rosalia	f
Rosalie	f
Rosalina	f
Rosalind	f
Rosalyn	f
Rosanna	f
Rosanne	f
Rosario	m
Rosco	m
Roscoe	m
Rose	f
Rosecrans	m
Rosemarijn	f
Rosemary	f
Rosenberg	m
Rosenmöller	m
Rosetta	f
Rosette	f
Rosier	m
Rosiers	m
Rosine	f
Rosita	f
Ross
Rossana	f
Rosseel	m
Rossi	m
Rossini	m
Rostov	m
Roth	m
Rothko	m
Rothman	m
Rotsaert	m
Rotterdammer	m
Rotterdamse	f
Rouke	m
Rous	m
Rousseau	m
Rousseff	f
Rouvoet	m
Roué	m
Rowan	m
Rowdy	m
Rowena	f
Rowling	f
Roxana	f
Roxann	f
Roxanne	f
Roy	m
Roy Makaay	m
Roy Sentjens	m
Roya	f
Royce	m
Royston	m
Roza	f
Rozalie	f
Rozemarijn	f
Roëll	m
Ru	m
Ruben	m
Rubens	m
Rubin	m
Ruby	f
Rubén	m
Ruckstuhl	f
Rudd	m
Rudi	m
Rudi Fuchs	m
Rudi Vranckx	m
Rudie	m
Rudolf	m
Rudolf Diesel	m
Rudolph	m
Rudolphus	m
Rudy	m
Rudy Aernoudt	m
Rudy Demotte	m
Rudy Kousbroek	m
Rudyard	m
Ruerd	m
Rufus	m
Ruggero	m
Ruggiero	m
Rugova	m
Rui	m
Ruiz	m
Rukiye	f
Rumsfeld	m
Rune	m
Runje	m
Rupel Boom	m
Rupert	m
Rurik	m
Rus	m
Rusedski	m
Rushdie	m
Russel	m
Russell	m
Russin	f
Rutger	m
Ruth	f
Rutherford	m
Ruthger	m
Rutte	m
Ruud	m
Ruud Gullit	m
Ruud de Wild	m
Ruud van Nistelrooij	m
Ruud van Nistelrooy	m
Ruurd	m
Ruurt	m
Ruut	m
Ruys	m
Rwandees	m
Rwandese	f
Ryan	m
Ryanne	f
Rypke	m
Ryszard	m
Rámon	m
Räikkönen	m
Régine	f
Régis	m
Rémi	m
Rémon	m
Rémy	m
Röhm	m
Röhrl	m
Röntgen	m
Rüdiger	m
Rühmann	m
SAfina	f
Sa Pinto	m
Saad	m
Saakasjvili	m
Saar	f
Saarinen	f
Saartje	f
Saban	m
Sabina	f
Sabine	f
Sabine Hagedoren	f
Sabrina	f
Sabrine	f
Sabriye	f
Sacco	m
Sacha	f
Sachin	m
Saciid Saleebaan	m
Saddam	m
Saddam Hoessein	m
Saddam Hussein	m
Sade	f
Sadet	f
Sadettin	m
Sadie	f
Sadik	m
Sadiki	m
Sady	f
Safah	f
Saffron	f
Safin	m
Safina	f
Safiya	f
Safiye	f
Sagakian	m
Sagalassos	m
Sage	f
Sahin	m
Sahra	f
Sai	m
Sai Setthatirat	m
Said	m
Said Nursi	m
Saida	f
Saied	m
Saif	m
Saim	m
Saint-Luciaan	m
Saint-Luciaanse	f
Sainz	m
Saive	m
Saiz	m
Sake	m
Sakina	f
Saks	m
Saksische	f
Sal	m
Sala	m
Saladin	m
Salah	m
Saleh	m
Salem	m
Salif Keita	m
Salim	m
Salinas	m
Sallander	m
Sallandse	f
Sallinen	m
Sally	f
Salma	f
Salman	m
Salmon	m
Salo	m
Salomo	m
Salomon	m
Salomé	f
Salou	m
Salou Ibrahim	m
Salvador	m
Salvadoraan	m
Salvadoraanse	f
Salvatore	m
Salwa	f
Sam	m
Sam Gooris	m
Samain	m
Samantha	f
Samaranch	m
Samaritaan	m
Samaritaanse	f
Sameer	m
Sami	m
Samih	m
Samiha	f
Samir	m
Samira	f
Sammy	m
Samora	f
Sampras	m
Samson	m
Samsun	f
Samuel	m
Samuel Delvaux	m
Samuel Pepys	m
Samuele	m
Samuël	m
Sana	f
Sanchez	m
Sancho	m
Sandberg	m
Sandeep	m
Sander	m
Sanderijn	f
Sanders	m
Sandor	m
Sandra	f
Sandra Bullock	f
Sandra Kim	f
Sandrijn	f
Sandrine	f
Sandro	m
Sands	m
Sandy	f
Sandy Coast	m
Sandy Martens	m
Sangeeta	f
Sanja	f
Sanjay	m
Sanmarinees	m
Sanmarinese	f
Sanna	f
Sanne	f
Sannen	m
Sanny	f
Sanofi	m
Santa	f
Santa Anna	m
Santa Cruz	m
Santana
Santer	m
Santi	m
Santiago	m
Santiagose	f
Santiagoër	m
Santomees	m
Santomese	f
Santos	m
Saoirse	f
Sapec	m
Sappho	f
Sara	f
Sara Peeters	f
Sarah	f
Sarah Palin	f
Sard	m
Sardische	f
Sarel	m
Sarghenta	f
Sargon	m
Sari	f
Saris	m
Sarita	f
Sarkozy	m
Sartre	m
Saruman	m
Sas	m
Sascha	f
Sasha
Sasja
Saskia	f
Sastre	m
Sasuke	m
Satan	m
Satie	m
Saud	m
Saudische	f
Saudiër	m
Saul	m
Sauron	m
Sauser	m
Sauwens	m
Savanna	f
Savas	m
Saverio	m
Savina	f
Savio	m
Savitri	f
Savonarola	m
Sawsan	f
Saxton	m
Sayed	m
Saïd	m
Saïda	f
Scandinavische	f
Scandinaviër	m
Scarlet Witch	f
Scarlett	f
Scarlett Johansson	f
Scato	m
Schalken	m
Schamp	m
Schapers	m
Scheepbouwer	m
Scheepers	f
Scheerder	m
Scheffer	m
Scheir	m
Schelfhout	m
Schellens	m
Schelling	m
Schelte	m
Schelto	m
Schenk	m
Schepers	m
Scheringa	m
Scherre	f
Schiavone	f
Schiermonnikoger	m
Schiermonnikoogse	f
Schilder	m
Schiltz	m
Schimmelpenninck	m
Schipper	m
Schippers	m
Schleck	m
Schlesinger	m
Schmelzer	m
Schmid	m
Schmidt	m
Schmitt	m
Schmitz	m
Schnabel	m
Schneider	m
Schnittke	m
Schockaert	m
Schoenaerts	m
Schollaert	m
Scholte	m
Scholten	m
Scholtens	f
Schorpioen
Schot	m
Schotse	f
Schouppe	m
Schouten	m
Schouwenaar	m
Schram	m
Schrijvers	m
Schröder	m
Schubert	m
Schuermans	m
Schuil	m
Schuller	m
Schulte	m
Schultz	f
Schulz	m
Schumacher	m
Schuman	m
Schumi	m
Schuschnigg	m
Schutte	m
Schuurman	f
Schwab	m
Schwartz	m
Schwarz	m
Schwarzenegger	m
Schwarzman	m
Schweinsteiger	m
Schweitzer	m
Schüssel	m
Schütz	m
Scipio	m
Scolari	m
Scooby	m
Scorsese	m
Scott	m
Scott Joplin	m
Scribe	m
Sean	m
Sean De Bie	m
Sebastiaan	m
Sebastian	m
Sebastian Vettel	m
Sebastiano	m
Sebastien	m
Sebastián	m
Securitas	m
Seda	f
Sedat	m
Seedorf	m
Sees	m
Sef	m
Sefanja	f
Segers	m
Seghers	m
Seif	m
Sekkaki	m
Sekularac	m
Selena	f
Seleucus	m
Selim	m
Selina	f
Sella	m
Selma	f
Selman	m
Selvi	f
Selwyn	m
Selçuk	m
Sem	m
Sema	f
Semih	m
Semira	f
Semjon	m
Sen	m
Sena	f
Seneca	m
Senegalees	m
Senegalese	f
Senna
Senne	m
Senol	m
Sensoa	m
Seouler	m
Seoulse	f
Sep Vanmarcke	m
Sepp	m
Sepp Blatter	m
Seppe	m
Seppe Goossens	m
Serdar	m
Serebrennikov	m
Serena	f
Serena Williams	f
Sereno	m
Serge	m
Serge Baguet	m
Serge Gainsbourg	m
Sergeant	m
Sergei	m
Sergej	m
Sergen	m
Sergey	m
Sergi	m
Serginho	m
Sergio	m
Sergio Conceiçao	m
Sergio Garcia	m
Sergius	m
Serhat Akin	m
Serra
Serrano	m
Servaas	m
Servaes	m
Servais	m
Servet	m
Servische	f
Serviër	m
Servé	m
Sesay	m
Seth	m
Sevcan	f
Seven	m
Severeyns	m
Severiano	m
Severine	f
Severino	m
Sevgi	f
Sevtap	f
Sextus	m
Seycheller	m
Seyfi	m
Seyma	f
Seynaeghel	m
Seyss-Inquart	m
Sezen	f
Sezer	m
Seán	m
Seçil	f
Shabana	f
Shabnam	f
Shackleton	m
Shah	m
Shaheen	m
Shahid	m
Shakespeare	m
Shakira	f
Shakur	m
Shamas	m
Shamsa	f
Shana	f
Shane	m
Shaneequa	f
Shani	f
Shania	f
Shannen	f
Shannon	f
Shaquille	m
Sharapova	f
Shari	f
Sharif	m
Sharleen	f
Sharon	f
Sharon Stone	f
Sharp	m
Sharyn	f
Shatra	m
Shaun	m
Shaw	m
Shawn	m
Shawna	f
Shay	m
Sheamus	m
Shearer	m
Sheherazade	f
Sheik	m
Sheikh	m
Sheila	f
Sheldon	m
Shelef	m
Shelley	f
Shepard	m
Sheri	f
Sheridan	m
Sherif	m
Sherlock Holmes	m
Sherman	m
Shervin	m
Sheryl	f
Shevchenko	m
Shields	f
Shingen	m
Shinichi Tetsutani	m
Shinji	m
Shinoda	m
Shireen	f
Shiri	f
Shirin	f
Shirley	f
Shorey	m
Short	f
Shorter	m
Siamees
Sian	f
Sibe	m
Sibel	f
Sibelius	m
Siberische	f
Siberiër	m
Sibon	m
Sibylle	f
Sicco	m
Sichon	m
Siciliaan	m
Siciliaanse	f
Sid	m
Sidi	m
Sidney	m
Sidon	m
Sieb	m
Siebe	m
Siebert	m
Siebold	m
Siebrechtje	f
Siebren	m
Sieger	m
Siegfried	m
Siegfried Bracke	m
Siegfried Verbeke WEL	m
Siem	m
Sieme	m
Siemon	m
Sien	f
Siena	f
Sieneke	f
Sienna	f
Sientje	f
Siep	m
Siepman	m
Sierd	m
Sierens	m
Sierk	m
Sierra	f
Sierraleoner	m
Sierraleonese	f
Sies	m
Sieske	f
Sieto	m
Sietse	m
Sietske	f
Sietze	m
Sieuwert	m
Siffer	m
Sigel	m
Siger	m
Sigismund	m
Sigmar	m
Sigmund	m
Sigmund Freud	m
Signe	f
Sigourney	f
Sigrid	f
Sigrid Vanden Bempt	f
Sigurd	m
Sijbolt	m
Sijbrands	m
Sijtje	f
Sil	m
Silezische	f
Sileziër	m
Silje	f
Silke	f
Silva
Silvain	m
Silvan	m
Silvana	f
Silvano	m
Silver	m
Silvester	m
Silvia	f
Silvian	m
Silvie	f
Silvio	m
Silvio Berlusconi	m
Silvo	m
Silvy	f
Sima	f
Simba	m
Simen	m
Simeon	m
Simeone	m
Simon	m
Simon Carmiggelt	m
Simon Fortuyn	m
Simon Verhamme	m
Simon Vroemen	m
Simone	f
Simoni	m
Simonis	m
Simonne	f
Simons	m
Simpson	m
Simson	m
Sin	f
Sina	f
Sinan	m
Sinatra	m
Sinbad	m
Sinclair	m
Sinead	f
Singaporees	m
Singaporese	f
Singer	m
Singh	m
Sini	f
Sinouh	m
Sint	m
Sint Truiden	m
Sint-Helener	m
Sint-Lenaarts	m
Sint-Maarten	m
Sint-Nicolaas	m
Sint-Petersburger	m
Sint-Petersburgse	f
Sinterklaas	m
Siny	f
Siobhan	f
Sioen	m
Sione	f
Sip	m
Sipke	m
Sire	m
Sisi	f
Sissy	f
Sister P.	f
Sita	m
Six	m
Sixtus	m
Sjaak	m
Sjaan	f
Sjaantje	f
Sjakie	m
Sjalabi	m
Sjamil	m
Sjanghaier	m
Sjanghaise	f
Sjanna	f
Sjarapova	f
Sjaron	m
Sjef	m
Sjeng	m
Sjeng Schalken	m
Sjevardnadze	m
Sjevtsjenko	m
Sjifra	f
Sjirov	m
Sjoera	f
Sjoerd	m
Sjoerd Wagenaar	m
Sjon	m
Sjors	m
Sjostakovitsj	m
Sjouke	m
Sjoukje	f
Sjuul	m
Skander	m
Skilling	m
Skinner	m
Skip	m
Skye	f
Skynet	m
Slaets	m
Slakhoorn	m
Slangen	m
Slater	m
Slaven	m
Slavonische	f
Slavoniër	m
Sleeckx	m
Sleeswijk-Holsteiner	m
Sleeswijk-Holsteinse	f
Slimane	m
Slobodan	m
Slobodan Milosevic	m
Sloot	m
Slot	m
Sloveen	m
Sloveense	f
Slovic	m
Slowaak	m
Slowaakse	f
Sluis	m
Sluiter	m
Sluys	m
Smeets	m
Smet	m
Smets	m
Smid	m
Smits	m
Smolarek	m
Smolders	m
Smout	m
Smulders	m
Smyth	f
Sneep	m
Sneijder	m
Snel	m
Snelders	m
Snijders	m
Snoeckx	m
Snoek	m
Snoop Dogg	m
Snow	m
Soad	f
Soba	m
Sobry	m
Socrates	m
Soeharto	m
Soekarno	m
Soendanees	m
Soendanese	f
Soetaers	m
Soete	m
Soetkin	f
Sofia	f
Sofie	f
Sofie Oyen	f
Sofioot	m
Sofiotische	f
Sofitel	m
Sofyan	m
Sohail	m
Sohan	m
Sokoerov	m
Sokolov	m
Sol	m
Solana
Solange	f
Soledad	f
Soledad Urdaneta	f
Soleil	f
Sologoeb	m
Solomon	m
Somalische	f
Somaliër	m
Somers	m
Son	m
Sonck	m
Sonderman	m
Soner	m
Song	m
Sonia	f
Sonia Gandhi	f
Sonja	f
Sonja Barend	f
Sonja Henie	f
Sonnie	m
Sonny	m
Sonoy	m
Sonya	f
Soong	m
Sophia	f
Sophie	f
Sophy	f
Soraya	f
Sorgdrager	f
Soros	m
Sosabowski	m
Souad	f
Spaan	m
Spaanse	f
Spanjaard	m
Spanjool
Sparta Petegem	m
Spartacus	m
Spears	f
Spector	m
Speer	m
Spencer	m
Spielberg	m
Spijkers	m
Spike	m
Spike Lee	m
Spilliaert	m
Spinola	m
Spinoy	m
Spinoza	m
Spitaels	m
Splinter	m
Spock	m
SpongeBob	m
Spooren	m
Sporting Anderlecht	m
Sprenger	m
Spreutels	m
Spring	m
Springsteen	m
Squirty	f
Sri	f
Srilankaan	m
Srilankaanse	f
Staal	m
Stacey	f
Stacy	f
Staes	m
Staf	m
Staf Coppens	m
Stafke Fabri	m
Stalin	m
Stallone	m
Stam	m
StampGirl	m
Stan	m
Stan Haag	m
Stan Van Samang	m
Standaert	m
Stanford	m
Stanislas	m
Stanislaus	m
Stanislav	m
Stanislavski	m
Stanislaw	m
Stanislawa	f
Stanley	m
Stanley Menzo	m
Stanly	m
Stanton	m
Stany	m
Starck	m
Starr	m
Stassin	m
Stavros	m
Steef	m
Steegmans	m
Steele	m
Steels	m
Steenbeek	f
Steenbok
Steenhuis	m
Steens	m
Stef	m
Stef Bos	m
Stef Wils	m
Stefaan	m
Stefaan De Clerck	m
Stefaan Maene	m
Stefan	m
Stefan Everts	m
Stefan Wijnands	m
Stefanas	m
Stefania	f
Stefanie	f
Stefano	m
Stefano Garzelli	m
Stefanos	m
Stefanus	m
Stefany	f
Steffen	m
Steffi	f
Steffi Graf	f
Steffie	f
Stegeman	m
Stein	m
Stein Huysegems	m
Steinar	m
Steiner	m
Steinmetz	m
Stekelenburg	m
Stelios	m
Stella	f
Stella McCartney	f
Stellwagen	m
Sten	m
Sten Raeymakers	m
Stendhal	m
Stephan	m
Stephan Eberharter	m
Stephane	m
Stephanie	f
Stephano	m
Stephanus	m
Stephen	m
Stephen Hendry	m
Stephen King	m
Stephen Laybutt	m
Stephenson	m
Sterchele	m
Sterckx	m
Stern	m
Sterre	f
Stevaert	m
Stevan	m
Steve	m
Steve Adam	m
Steve Darcis	m
Steve Jobs	m
Steve Ramon	m
Steve Schets	m
Steve Stevaert	m
Steve Vai	m
Steven	m
Steven Defour	m
Steven Gerrard	m
Steven Martens	m
Steven Spielberg	m
Stevens	m
Stevenson	m
Stevie	m
Stevie Wonder	m
Stevin	m
Stewart	m
Stien	f
Stier
Stig	m
Stijn	m
Stijn Devolder	m
Stijn Goris	m
Stijn Meuris	m
Stijn Minne	m
Stijn Streuvels	m
Stijn Stroobants	m
Stijnen	m
Stine	f
Sting	m
Stirner	m
Stockholmer	m
Stockholmse	f
Stockman	m
Stoiber	m
Stoica	m
Stojanovic	m
Stoltenberg	m
Storm	m
Straatsburger	m
Straatsburgse	f
Stratus	f
Strauss	m
Stravinsky	m
Straw	m
Stremersch	m
Streuvels	m
Strijbos	m
Strole	m
Stroobants	m
Stuart	m
Sturkenboom	m
Stybar	m
Stéphan	m
Stéphane	m
Suarez	m
Suat	m
Sudanees	m
Sudanese	f
Sue	f
Suet	f
Suez Lyonnaise	f
Sugar Jackson	m
Suk	f
Suleiman	m
Suleyman	m
Sulla	m
Sullivan	m
Sultan	f
Sumaya	f
Summers	m
Sun Quan	m
Sunita	f
Sunitinib	m
Sunny	m
Sureyya	f
Surinaamse	f
Surinamer	m
Surt	m
Susan	f
Susana	f
Susanna	f
Susannah	f
Susanne	f
Suse	f
Sushmita	f
Susie	f
Suske	m
Sussanne	f
Sutherland	m
Sutton	m
Suu Kyi	f
Suus	f
Suzan	f
Suzanna	f
Suzanne	f
Suze	f
Suzette	f
Suzie	f
Suzy	f
Suárez	m
Sven	m
Sven Kramer	m
Sven Nijs	m
Sven Nooytens	m
Sven Nys	m
Sven Vandousselaere	m
Sven Vanthourenhout	m
Sven-Goran Eriksson	m
Svensson	m
Svetlana	f
Svetlana Khorkina	f
Swaan	f
Swagerman	m
Swazi	m
Swazische	f
Sweder	m
Swen	m
Swennen	m
Swift	m
Swinkels	m
Syb	m
Sybe	m
Sybilla	f
Sybille	f
Sybolt	m
Sybrand	m
Sybren	m
Syed	m
Sylke	f
Sylvain	m
Sylvain Tack	m
Sylvana	f
Sylvano	m
Sylvester	m
Sylvia	f
Sylvian	m
Sylvie	f
Sylvio	m
Symone	f
Syrische	f
Syriër	m
Systemat	m
Sytse	m
Sytske	f
Sytze	m
Syx	m
Szulc-Krzyzanowski	m
Sáblíková	f
Sánchez	m
Sándor	m
Séan	m
Sébastien	m
Sébastien Loeb	m
Sédir	m
Ségolène Royal	f
Sérgio	m
Söderling	m
Sören	m
Sörensen	m
Søren	m
Sørensen	m
Sükrü	m
Süleyman	m
T'Kint	m
Tabaksblat	m
Tabe	m
Tachtiger	m
Tacitus	m
Tack	m
Taco	m
Tadeusz	m
Tadic	m
Tadić	m
Tadzjiek	m
Tadzjiekse	f
Taeke	m
Taeke Taekema	m
Tahar	m
Taillieu	m
Taiwanees	m
Taiwanese	f
Tajmijja	m
Tak	m
Talia	f
Talitha	f
Tamar	f
Tamara	f
Tamarah	f
Tamas	m
Tamer	m
Tamim	m
Tamino	m
Tamme	m
Tammy	f
Tamsin	f
Tamás	m
Tan	m
Tanaka	m
Tandja	m
Tang	m
Tanghe	m
Tania	f
Tanja	f
Tanja Dexters	f
Tanju	m
Tanneke	f
Tanny	f
Tansu	f
Tanya	f
Tanzaniaan	m
Tanzaniaanse	f
Tanzi	m
Taoufik	m
Tara	f
Tarantino	m
Taras	m
Tarek	m
Tarentijn	m
Tarentijnse	f
Tareq	m
Tarik	m
Tariq	m
Tarja	f
Tarkan	m
Tarkovski	m
Tarquin	m
Taryn	f
Tasha	f
Tashi	m
Tasmaanse	f
Tasmaniër	m
Tastenhoye	m
Tata	m
Tati	m
Tatjana	f
Tatum	f
Tavernier	m
Tawfik	m
Taxquet	m
Tayfun	m
Tayfur	m
Taylor	f
Tayyip	m
Tchite	m
Tchité	m
Technico	m
Ted	m
Teddy
Teeuwen	m
Teheraanse	f
Teheraner	m
Teije	m
Teke	m
Tekin	m
Tekstra	m
Teletovic	m
Telindus	m
Tellegen	m
Telly	m
Telseara	f
Temmerman	m
Ten Brink	m
Tenet	m
Tennes	m
Tennyson	m
Tenzin	m
Teo	m
Tepe	m
Ter Beek	m
Ter Beke	m
Ter Braak	m
Ter Horst	f
Terence	m
Teresa	f
Tergat	m
Teri	f
Terje	m
Termont	m
Terpen Tijn	m
Terrance	m
Terrence	m
Terri	f
Terry	m
Terschellinger	m
Terschellingse	f
Tess	f
Tessa	f
Tessenderlo Chemie	m
Tetricus	m
Teun	m
Teunis	m
Teus	m
Tex	m
Texelaar	m
Texelse	f
Thaddeus	m
Thai	m
Thaise	f
Thaksin	m
Thalita	f
Thalys	m
Thamar	f
Thami	m
Thatcher	f
The	m
Thea	f
Thebaan	m
Thebaanse	f
Thecla	f
Thedo	m
Thekla	f
Theo	m
Theo Aerts	m
Theo Maassen	m
Theobald	m
Theodoor	m
Theodor	m
Theodora	f
Theodore	m
Theodoricus	m
Theodoros	m
Theodorus	m
Theodosius	m
Theophil	m
Theophile	m
Theophilus	m
Theresa	f
Therese	f
Theroux	m
Therèse	f
Thes	m
Theseus	m
Theu Boermans	m
Theun	m
Theunis	m
Theunissen	m
Theyskens	m
Thibault	m
Thibault Koppen	m
Thibaut	m
Thida	f
Thiebaut	m
Thielemans	m
Thieme	m
Thieren	m
Thierno	m
Thierry	m
Thierry Henry	m
Thijl	m
Thijm	m
Thijn	m
Thijs	m
Thijs van Valkengoed	m
Thijssen	m
Thimo	m
Thoenes	m
Thom	m
Thom Yorke	m
Thom de Graaf	m
Thomas	m
Thomas Buffel	m
Thomas Caers	m
Thomas Chatelle	m
Thomas Cook	m
Thomas Dekker	m
Thomas Edison	m
Thomas More	m
Thomas Troch	m
Thomas Vermaelen	m
Thompson	m
Thomson	m
Thony	m
Thor	m
Thor Hushovd	m
Thorbecke	m
Thorne	m
Thorpe	m
Thorsson	m
Thorsten	m
Thorvald	m
Thorwald	m
Thracische	f
Thraciër	m
Thrasea	m
Thuram	m
Thybil	m
Thys	m
Thé Lau	m
Théodore	m
Théophile	m
Thérèse	f
Tia	f
Tia Hellebaut	f
Tian	m
Tibbets	m
Tiberius	m
Tibetaan	m
Tibetaanse	f
Tibor	m
Tico	m
Tieleman	m
Tielen	m
Tieme	m
Tiemen	m
Tienen United	m
Tiepolo	m
Ties	m
Tiffany	f
Tiger Woods	m
Tigran	m
Tihinen	m
Tijani	m
Tijl	m
Tijmen	m
Tijn	m
Tijs	m
Tijs Mauroo	m
Tijsmans	m
Tilburger	m
Tilburgse	f
Tilda	f
Tillie	f
Tillmans	m
Tilly	f
Tilmant	m
Tim	m
Tim Clerbout	m
Tim Montgomery	m
Timberlake	m
Timman	m
Timme	m
Timmer	f
Timmerman	m
Timmermans	m
Timmie	m
Timmy	m
Timmy Simons	m
Timo	m
Timo Kanst	m
Timoer	m
Timon	m
Timosjenko	f
Timoteüs	m
Timothy	m
Timothy Dreesen	m
Timothy Vanmassenhove	m
Tina	f
Tindemans	m
Tine	f
Tine Bossuyt	f
Tineke	f
Tini	f
Tinie	f
Tino	m
Tino Pellegriti	m
Tintin	m
Tinus	m
Tiny	f
Tiong	m
Tip	m
Tippett	m
Tippi	f
Tipsarević	m
Tiranees	m
Tiranese	f
Tirza	f
Tita	f
Titia	f
Tito	m
Titus	m
Tiziana	f
Tiziano	m
Tiësto	m
Tjaard	m
Tjaart	m
Tjaco	m
Tjalle	m
Tjalling	m
Tjan	m
Tjard	m
Tjarda	f
Tjark	m
Tjebbe	m
Tjebbo	m
Tjeerd	m
Tjerk	m
Tjeu	m
Tjibbe	m
Tjisse	m
Tjitse	m
Tjitske	f
Tjitte	m
Tjitze	m
Tjololo	m
To	f
Tobback	m
Tobey	m
Tobias	m
Tobin	m
Tobit	m
Toby	m
Todd	m
Toer	m
Togolees	m
Togolese	f
Toine	m
Toke	f
Tokiose	f
Tokioër	m
Tol	f
Tolkien	m
Tom	m
Tom Barman	m
Tom Boonen	m
Tom Caluwé	m
Tom Compernolle	m
Tom Cruise	m
Tom De Sutter	m
Tom Desmet	m
Tom Ford	m
Tom Junior	m
Tom Lanoye	m
Tom Lenaerts	m
Tom Meeusen	m
Tom Mewis	m
Tom Prinsen	m
Tom Soetaers	m
Tom Stubbe	m
Tom Van Aelst	m
Tom Van Geneugden	m
Tom Van Hooste	m
Tom Van Oost	m
Tom Vangeneugden	m
Tom Vannoppen	m
Tom Waes	m
Tom Waits	m
Tomas	m
Tomas Ross	m
Tomas Van Den Spiegel	m
Tomasson	m
Tomasz	m
Tomek	m
Tomislav	m
Tommaso	m
Tommi	m
Tommie	m
Tommy	m
Tommy Hilfiger	m
Tommy Lee Jones	m
Tomou	m
Tomás	m
Ton	m
Ton Sijbrands	m
Tonckens	m
Tong	m
Tongaan	m
Tongaanse	f
Toni	m
Tonia	f
Tonie	m
Tonino	m
Tonio	m
Tonke	f
Tonko	m
Tonnie	m
Tonny	m
Tony	m
Tony Blair	m
Tony Mary	m
Tony Soprano	m
Tonya	f
Toon	m
Toontje	f
Toos	f
Tooske	f
Toots	m
Toots Thielemans	m
Topalov	m
Toprak	m
Tore	m
Torfs	m
Tori	f
Torres	m
Torsten	m
Tosca	f
Toscaan	m
Toscaanse	f
Toscani	m
Tosin Dosunmu	m
Totila	m
Tottenham	m
Totti	m
Toure	m
Touriya	f
Toussaint	m
Townshend	m
Toyah	f
Trabelsi	m
Tracey	f
Tracy	f
Trajanus	m
Transsylvanische	f
Transsylvaniër	m
Trapattoni	m
Travis	m
Travolta	m
Trees	f
Trevor	m
Trey	m
Trezeguet	m
Trichet	m
Trijn	f
Trijnie	f
Trijntje	f
Trimble	m
Trina	f
Trinus	m
Triple H	m
Tripolitaan	m
Tripolitaanse	f
Trish	f
Tristan	m
Tristan Hoffman	m
Trix	f
Triëster	m
Triëstse	f
Troch	m
Troelstra	m
Tromp	m
Trond Sollied	m
Trost	m
Trotski	m
Trotsky	m
Troubleyn	m
Troy	m
Troy Douglas	m
Trude	f
Trudie	f
Trudy	f
Trujillo	m
Trulli	m
Truman	m
Truman Capote	m
Trump	m
Truong	m
Truus	f
Truusje	f
Truyens	m
Tsai	m
Tshisekedi	m
Tshombe	m
Tsjaadse	f
Tsjadiër	m
Tsjaikovski	m
Tsjech	m
Tsjechische	f
Tsjechov	m
Tsjizjov	m
Tsjoebais	m
Tsjoen	m
Tuan	m
Tuare	m
Tuba	f
Tucker	m
Tudjman	m
Tudor	m
Tugay	m
Tuitert	m
Tuk	m
Tukker	m
Tula	m
Tullia	f
Tully	m
Tuncer	m
Tunesische	f
Tunesiër	m
Tung	m
Tupac	m
Tura	m
Turgut	m
Turijner	m
Turijnse	f
Turk	m
Turkish	m
Turkmeen	m
Turkmeense	f
Turkse	f
Turner	m
Tuur	m
Tuvaluaan	m
Tuvaluaanse	f
Tuybens	m
Tuymans	m
Twain	m
Twan	m
Twent	m
Twentse	f
Ty	m
Tycho	m
Tyler	m
Tyler Brûlé	m
Tyler Hamilton	m
Tymen	m
Tyrone	m
Tyson	m
Túrin	m
Türker	m
Ubbo	m
Uday	m
Udo	m
Ugandees	m
Ugandese	f
Ugo	m
Ugur	m
Ulco	m
Ulla	f
Ullrich	m
Ulrich	m
Ulrich Salchow	m
Ulrika	f
Ulrike	f
Uma	f
Uma Thurman	f
Umar	m
Umberto	m
Umbrische	f
Umbriër	m
Umicore	m
Umit	m
Una	f
Unal	m
Uncle Al	m
Unibet	m
Union Saint-Gilloise	m
Urabi	m
Urbain	m
Urbain Spaenhoven	m
Urban	m
Urbanus	m
Uri	m
Uribe	m
Uriël	m
Urquhart	m
Ursula	f
Uruguayaan	m
Uruguayaanse	f
Usain Bolt	m
Usman	m
Utaka	m
Ute	f
Utrechter	m
Utrechtse	f
Uuno Klami	m
Uvalin	m
Uwe	m
Uytdehaage	m
Uyttendaele	m
Uzza	m
VIP
VN'er
VWO'er
Vader	m
Vader Abraham	m
Vadim	m
Vaessen	m
Vail	m
Vajpayee	m
Valdemar	m
Valentijn	m
Valentin	m
Valentina	f
Valentine	f
Valentinianus	m
Valentino	m
Valentinus	m
Valeri	f
Valeria	f
Valerie	f
Valerio	m
Valerius	m
Valery	f
Valgaeren	m
Valk	m
Valkeniers	m
Vally	m
Valverde	m
Valérie	f
Valéry	f
Valéry Giscard d'Estaing	m
Van	m
Van 't Hek	m
Van Aartsen	m
Van Abkoude	m
Van Acker	m
Van Aelst	m
Van Aerschot	m
Van Amen	m
Van Amerongen	m
Van Aperen	m
Van Ardenne	f
Van Arkel	m
Van Arum	m
Van As	m
Van Assche	m
Van Avermaet	m
Van Baelen	m
Van Barneveld	m
Van Basten	m
Van Beek	m
Van Beers	m
Van Beirendonck	m
Van Belle	m
Van Beuningen	m
Van Bommel	m
Van Bouwel	m
Van Boven	m
Van Boxtel	m
Van Branteghem	m
Van Breedam	m
Van Brempt	f
Van Broekhoven	m
Van Buggenhout	m
Van Buitenen	m
Van Butsel	m
Van Buuren	m
Van Buyten	m
Van Camp	m
Van Campenhout	m
Van Cau	m
Van Cauwelaert	m
Van Cauwenberghe	m
Van Cleemput	m
Van Commenée	m
Van Daele	m
Van Dam	m
Van Damme	m
Van De Sompel	m
Van De Velde	m
Van De Walle	m
Van Delft	m
Van Den Bergh	m
Van Den Berghe	m
Van Den Bosch	m
Van Den Bossche	m
Van Den Brande	m
Van Den Eynde	m
Van Den Heuvel	m
Van Der Hoeven	m
Van Der Straeten	m
Van Deun	m
Van Deursen	m
Van Diepenbeeck	m
Van Dievel	m
Van Dijck	m
Van Dis	m
Van Doesburg	m
Van Doodewaerd	m
Van Doorn	m
Van Doorne	f
Van Dorn	m
Van Dorp	m
Van Driel	m
Van Duin	m
Van Dyken	f
Van Eeden	m
Van Eesteren	m
Van Egmond	m
Van Erp	m
Van Erven Dorens	m
Van Esbroeck	m
Van Eupen	f
Van Eyck	m
Van Gaal	m
Van Galen	m
Van Geel	m
Van Gelder	m
Van Gele	m
Van Gemert	m
Van Gerwen	m
Van Gessel	m
Van Gestel	m
Van Ginkel	m
Van Goethem	m
Van Gogh	m
Van Gompel	m
Van Gool	m
Van Goolen	m
Van Gorp	m
Van Grembergen	m
Van Grunsven	f
Van Gulik	m
Van Hall	m
Van Halst	m
Van Handenhoven	m
Van Hecke	m
Van Heerden	m
Van Hellemond	m
Van Herck	m
Van Herreweghe	m
Van Himst	m
Van Hoevelen	m
Van Holsbeeck	m
Van Hoof	m
Van Hooijdonk	m
Van Hool	m
Van Hooland	m
Van Hooste	m
Van Houdt	m
Van Hove	m
Van Huet	m
Van Hulst	m
Van Impe	m
Van In	m
Van Istendael	m
Van Kan	m
Van Kasteren	m
Van Keirsbulck	m
Van Kemenade	m
Van Kempen	m
Van Kerckhoven	m
Van Kessel	m
Van Keulen
Van Kleffens	m
Van Kooten	m
Van Krimpen	m
Van Laecke	m
Van Laer	m
Van Laere	m
Van Laethem	m
Van Landeghem	m
Van Lanschot	m
Van Leeuwen	m
Van Lierde	m
Van Loo	m
Van Loon	m
Van Looy	m
Van Lottum	m
Van Maanen	m
Van Maaren	f
Van Marwijk	m
Van Mechelen	m
Van Mieghem	m
Van Mierlo	m
Van Miert	m
Van Mol	m
Van Montfort	m
Van Moorsel	f
Van Mourik	m
Van Mullem	m
Van Nazareth	m
Van Nes	f
Van Nieuwenhoven	f
Van Nieuwenhuyse	m
Van Nistelrooij	m
Van Nistelrooy	m
Van Oijen	m
Van Oost	m
Van Ostaijen	m
Van Overtvelt	m
Van Paemel	f
Van Parys	m
Van Passel	m
Van Peel	m
Van Pelt	m
Van Persie	m
Van Petegem	m
Van Poppel	m
Van Poucke	m
Van Praet	m
Van Quickenborne	m
Van Raaij	m
Van Rappard	m
Van Rees	m
Van Riemsdijk	m
Van Roe	m
Van Rompay	m
Van Rompuy	m
Van Rooijen	m
Van Roosbroeck	m
Van Roost	m
Van Rooy	m
Van Rossom	m
Van Royen	f
Van Sande	m
Van Sant	m
Van Scheppingen	m
Van Severen	m
Van Speybroeck	m
Van Springel	m
Van Staeyen	m
Van Steen	m
Van Stralen	f
Van Straten	m
Van Thillo	m
Van Tichelt	m
Van Torre	m
Van Traa	m
Van Veelen	m
Van Velde	m
Van Veldhoven	m
Van Velzen	m
Van Vlaenderen	m
Van Vlijmen	m
Van Vossen	m
Van Vught	m
Van Waes	m
Van Weert	f
Van Wely	m
Van Westerloo	m
Van Wieren	m
Van Wijk	m
Van Wijnendaele	m
Van Winter	m
Van Wolferen	m
Van Wonderen	m
Van Wymersch	m
Van Zele	m
Van Zomeren	m
Van Zon	m
Van Zundert	m
Van Zweden	m
Van Zweeden	m
Van de Kerckhove	m
Van de Paar	m
Van de Perre	m
Van de Poel	m
Van de Pol	m
Van de Putte	m
Van de Veire	m
Van de Velde	m
Van de Vondel	m
Van de Weerd	m
Van de Weghe	m
Van de Weyer	m
Van den Abeele	m
Van den Berg	m
Van den Bergh	m
Van den Berghe	m
Van den Bos	m
Van den Bosch	m
Van den Bossche	f
Van den Brande	m
Van den Brink	m
Van den Broeck	m
Van den Broek	m
Van den Broeke	m
Van den Durpel	m
Van den Ende	m
Van den Eynde	m
Van den Herik	m
Van den Heuvel	m
Van den Honert	m
Van den Hoogenband	m
Van den Hoven	m
Van den Nieuwenhuyzen	m
Van den Schoor	m
Van der Biest	m
Van der Donck	m
Van der Elst	m
Van der Geest	m
Van der Gouw	m
Van der Heide	m
Van der Heijden	m
Van der Hilst	m
Van der Jeugt	m
Van der Knaap	m
Van der Lem	m
Van der Linden	m
Van der Lubbe	m
Van der Meer	m
Van der Meulen	m
Van der Noot	m
Van der Pas	m
Van der Perren	m
Van der Plaats	f
Van der Ploeg	m
Van der Poel	m
Van der Pol	m
Van der Reijden	m
Van der Sar	m
Van der Schaaf	m
Van der Schoot	m
Van der Sloot	m
Van der Tak	m
Van der Vaart	m
Van der Valk	m
Van der Veen	m
Van der Veer	m
Van der Velde	m
Van der Waerden	m
Van der Weerden	m
Van der Werff	m
VanKrunk	m
Vanaudenaerde	m
Vance	m
Vandaele	m
Vandamme	m
Vandana	f
Vande Lanotte	m
Vandecaveye	f
Vandekerckhove	m
Vandekeybus	m
Vandeloo	m
Vanden Boeynants	m
Vanden Borre	m
Vanden Stock	m
Vandenabeele	m
Vandenberg	m
Vandenbergh	m
Vandenberghe	m
Vandenbroeck	m
Vandenbroucke	m
Vandenbussche	m
Vandendriessche	m
Vandenhaute	m
Vandenhove	m
Vandereycken	m
Vanderhaeghe	m
Vanderheere	m
Vanderkelen	m
Vandermarliere	m
Vandermeersch	m
Vanderpoorten	f
Vandersteen	m
Vandervelden	m
Vandeurzen	m
Vandevenne	m
Vandewalle	m
Vandoorne	m
Vandousselaere	m
Vanendert	m
Vanessa	f
Vangheluwe	m
Vanhaezebrouck	m
Vanhamel	m
Vanhecke	m
Vanhengel	m
Vanhoenacker	m
Vanhove	m
Vanhuffel	m
Vankrunkelsven	m
Vanmarcke	m
Vanneste	m
Vannieuwenhuyse	m
Vannoppen	m
Vanoudenhoven	m
Vansevenant	m
Vansteenkiste	m
Vanstiphout	m
Vanthomme	m
Vanthourenhout	m
Vantornout	m
Vanya	f
Vardenafil	m
Varela	m
Varg	m
Vargas
Vargas Llosa	m
Varo	m
Varsha	f
Vartan	m
Varus	m
Vasco	m
Vasilios	m
Vedder	m
Veenhof	m
Veenstra	m
Veerle	f
Veerle D'Haese	f
Veerle Dejaeghere	f
Veerman	m
Vekeman	m
Veldhuis	f
Veldkamp	m
Veluwenaar	m
Veluwse	f
Velázquez	m
Venema	m
Veneman	m
Venetiaan	m
Venetiaanse	f
Venezolaan	m
Venezolaanse	f
Vengerov	m
Venhuizen	m
Venlafaxine	m
Vennegoor of Hesselink	m
Venus	f
Venus Williams	f
Vera	f
Vera Dua	f
Veraart	m
Verbeeck	m
Verbeek	m
Verbeke	m
Verbiest	m
Verbroedering Geel	m
Verbroedering Meldert	m
Verbrugghe	m
Verburg	f
Vercammen	m
Vercamp	m
Vercauteren	m
Vercingetorix	m
Verdi	m
Verdonck	m
Verdonk	f
Verdoodt	m
Vere	f
Vereecke	m
Verelst	m
Vereyck	m
Verfaillie	m
Vergeylen	m
Vergote	m
Vergouwen	m
Vergucht	m
Verhaegen	m
Verhaeghe	m
Verhaeren	m
Verhagen	m
Verheijen	m
Verhelst	m
Verheugen	m
Verheyden	m
Verheyen	m
Verhoeven	m
Verhofstadt	m
Verhulst	m
Verkerk	m
Verkoyen	m
Verleyen	m
Verlinde	m
Verlinden	m
Vermaelen	m
Vermant	m
Vermeend	m
Vermeer	m
Vermeersch	m
Vermeij	m
Vermeire	m
Vermeiren	m
Vermeulen	m
Vermeulen-Raemdonck	m
Vermeyen	m
Verminnen	m
Vermote	m
Vernie	f
Verniers	m
Vernon	m
Veron	m
Verona	f
Veronica	f
Veronika	f
Veronique	f
Verplaetse	m
Verreycken	m
Verriest	m
Versavel	m
Verschaeren	m
Verschueren	m
Verschuuren	m
Verstand	f
Verstappen	m
Verstraete	m
Verstraeten	m
Verstrepen	m
Versyp	m
Vertonghen	m
Vervaeke	m
Vervaet	m
Vervecken	m
Vervliet	m
Vervloesem	m
Vervotte	f
Verwilghen	m
Verzele	m
Verón	m
Vesna	f
Vestdijk	m
Vettel	m
Vibeke	f
Vic	m
Vicente	m
Vicki	f
Vicky	f
Victor	m
Victor Bendix	m
Victor Emanuel	m
Victor Emmanuel	m
Victor Hugo	m
Victoria	f
Victorien	f
Victorine	f
Victory	f
Vidal	m
Vieira	m
Vietnamees	m
Vietnamese	f
Viggo	m
Vigo	m
Vijay	m
Vijftv	m
Vikash	m
Vikram	m
Viktor	m
Viktoria	f
Vilain	m
Villa	m
Villeneuve	m
Vilmar	m
Vilsack	m
Vilé	m
Vince	m
Vincent	m
Vincent Genot	m
Vincent Kompany	m
Vincent Van Diepenbeeck	m
Vincent Van Gogh	m
Vincent Van Quickenborne	m
Vincent van Gogh	m
Vincentius	m
Vincenzo	m
Vinck	m
Vink	m
Vinnie	m
Vino	m
Vinokoerov	m
Vinokourov	m
Viola	f
Violet	f
Violeta	f
Violette	f
Virenque	m
Virgie	f
Virgil	m
Virgilio	m
Virgilius	m
Virginia	f
Virginia Woolf	f
Virginie	f
Virna	f
Visser	m
Vissers	m
Vital Heynen	m
Vitalski	m
Vitas	m
Vitellius	m
Vito	m
Vitor	m
Vittorio	m
Vitus	m
Viva	f
Vivek	m
Vivi	f
Vivian	f
Vivian Alamain	f
Viviane	f
Vivien	f
Vivienne	f
Viviënne	f
Vl Belang	m
Vlaamse	f
Vlad	m
Vladan Devic	m
Vladimir	m
Vladimir Poetin	m
Vlaming	m
Vlasov	m
Vleminckx	m
Vlerick	m
Vliegen	m
Vlielander	m
Vlielandse	f
Vloet	m
Voeckler	m
Vogel	m
Voigt	m
Voldemort	m
Volkan	m
Volker	m
Volkert	m
Volkert van der G.	m
Voltaire	m
Von Braun	m
Von Galen	m
Von Neumann	m
Von Teese	f
Von der Dunk	m
Vonck	m
Vondel	m
Vonne	f
Voorhoeve	m
Vos	m
Voss	m
Vossen	m
Votron	m
Vrakking	m
Vrancken	m
Vranckx	m
Vranken	m
Vrasene	m
Vredeling	m
Vreeman	m
Vreugdenhil	m
Vreven	m
Vries	m
Vriesde	f
Vriesekoop	f
Vroemen	m
Vroon	m
Vuile Mong	m
Vuurlander	m
Vuurlandse	f
Vyncke	m
Véronique	f
Völler	m
W&L	m
W.F. Hermans	m
WAO'er
Waal	m
Waalse	f
Waddeneilander	m
Wade	m
Waelkens	m
Wafa	f
Wafrudnir	m
Wagemakers	m
Wagemans	m
Wagenaar	m
Wagner	m
Wahid	m
Wahlgren	m
Waits	m
Walach	m
Waldemar	m
Waldo	m
Walid	m
Walker	m
Wallace	m
Wallage	m
Wally	m
Walraven	m
Walravens	m
Walschaerts	m
Walschap	m
Walser	m
Walsh	m
Walt	m
Walt De Winter	m
Walt Disney	m
Walter	m
Walter Baseggio	m
Walter De Buck	m
Walter Grootaers	m
Walter Gropius	m
Walter Meeuws	m
Walter Van Beirendonck	m
Walther	m
Walton	m
Waltraud	f
Wamberto	m
Wan	f
Wanda	f
Wander	m
Wang	m
Wangari Maathai	f
Wannes	m
Ward	m
Ward Beysen	m
Warhol	m
Wariner	m
Wario	m
Waris Diri	f
Warna	f
Warner	m
Warren	m
Warschauer	m
Warschause	f
Waseige	m
Washington	m
Washingtonner	m
Washingtonse	f
Wasilewski	m
Wasp	f
Watanabe	m
Waterreus	m
Waters
Wathelet	m
Watts	m
Waylon	m
Wayne	m
Wayne Rooney	m
Weber	m
Webster	m
Weckx	m
Weense	f
Wei	m
Weijers	m
Weir	m
Weisglas	m
Weiss	m
Wellens	m
Weller	m
Welles	m
Wellesley	m
Wellingtonner	m
Wellingtonse	f
Welteke	m
Welten	m
Weltergewicht Sugar Jackson	m
Wenceslaus	m
Wende	f
Wendela	f
Wendelien	f
Wendelin	f
Wendell	m
Wendelmoet	f
Wendy	f
Wendy Den Haeze	f
Wendy Van Wanten	f
Wendy de Boer	f
Wener	m
Wenger	m
Wenneke	f
Wennemars	m
Wenzel	m
Wera	f
Werner	m
Weronika	f
Werrebrouck	m
Wes	m
Wesley	m
Wesley Sonck	m
Wesly	m
Wessel	m
Wesselius	m
Wessels	m
West	m
West-Duisland
West-Fries	m
West-Friese	f
West-Samoaan	m
West-Samoaanse	f
West-Vlaamse	f
West-Vlaming	m
Wester	m
Westwood	m
Wevers	m
Weyerman	m
Wheeler	m
White	m
Whitney	f
Wiarda	f
Wibe	m
Wibo	m
Wibren	m
Wichard	m
Wicher	m
Wichman	m
Wickmayer	f
Widerstehe	f
Widmann	m
Wiebe	m
Wiedeking	m
Wiegel	m
Wieger	m
Wiegman	f
Wiek	m
Wiel	m
Wieland	m
Wielinga	m
Wiemer	m
Wien	m
Wieneke	f
Wientjes	m
Wiep	f
Wierd	m
Wiersma	m
Wiert	m
Wiertz	m
Wies	f
Wieteke	f
Wietse	m
Wietske	f
Wietze	m
Wigbolt	m
Wijers	m
Wijmeersch	m
Wijn	m
Wijnand	m
Wijnanda	f
Wijnants	m
Wijntje	f
Wijtze	m
Wik	m
Wil	m
Wilbert	m
Wilbrand	m
Wilbur	m
Wilco	m
Wilde	m
Wilder	m
Wilders	m
Wildiers	m
Wilfred	m
Wilfred Bouma	m
Wilfrid	m
Wilfried	m
Wilfried Martens	m
Wilfried Meert	m
Wilhelm	m
Wilhelm II	m
Wilhelmina	f
Wilhelmsson	m
Wilhelmus	m
Wiliam	m
Wilja	f
Wiljam	m
Wiljan	m
Wiljo	m
Wilke	f
Wilkes	m
Wilkinson	m
Wilko	m
Will	m
Will Ferdy	m
Will Smith	m
Will Tura	m
Willard	m
Wille	m
Willebroek Meerhof	m
Willebrord	m
Willebrordus	m
Willeke	f
Willem	m
Willem Alexander	m
Willem Duys	m
Willem Elsschot	m
Willem I	m
Willem III	m
Willem Jan Otten	m
Willem V	m
Willem Vermandere	m
Willem de Veroveraar	m
Willem van Hanegem	m
Willem van Oranje	m
Willem-Alexander	m
Willemiek	f
Willemieke	f
Willemien	f
Willemijn	f
Willempje	f
Willems	m
Willemsen	m
Willemstadse	f
Willemstatter	m
Willi	m
William	m
William Lyons	m
William Schuman	m
William Shakespeare	m
William Verbeeck	m
William Walker	m
Williamson	m
Willibrord	m
Willie
Willis	m
Willockx	m
Willow	f
Willy
Willy Brandt	m
Willy Böckl	m
Willy Claes	m
Willy Sommers	m
Willy Vandersteen	m
Willy Wostyn	m
Wilma	f
Wilmar	m
Wilmink	m
Wilmots	m
Wilna	f
Wils	m
Wilson	m
Wilt	m
Wilton	m
Wim	m
Wim Duisenberg	m
Wim Jacobs	m
Wim Kok	m
Wim Oosterlinck	m
Wim Opbrouck	m
Wim Schröder	m
Wim Vanhuffel	m
Win	f
Wina	f
Winand	m
Winanda	f
Winants	m
Windhoeker	m
Windhoekse	f
Winfred	m
Winfried	m
Winifred	f
Winkel Sport	m
Winkler	m
Winne	m
Winnie	f
Winnifred	f
Winny	f
Winona	f
Winston	m
Winston Churchill	m
Winterbottom	m
Wiro	m
Wise	m
Wiske	f
Wisse	m
Wit	m
Wit-Rus	m
Wit-Russische	f
Witgoor	m
Witherspoon	f
Witold	m
Witschge	m
Witse	m
Witsel	m
Witte	m
Wivineke	f
Wladimir	m
Wladyslaw	m
Wobbe	m
Wodan	m
Woefer	m
Wolf	m
Wolfe	m
Wolfert	m
Wolff	m
Wolfgang	m
Wolfgang Amadeus Mozart	m
Wolfowitz	m
Wolfram	m
Wolfs	m
Wolkers	m
Wolter	m
Wolters	m
Woluwe	m
Wolverine	m
Wonder Woman	f
Wood	m
Woods	m
Woodward	m
Woody	m
Woody Allen	m
Wopke	m
Wotan	m
Wotherspoon	m
Wouda	f
Wouke	f
Wout	m
Wouter	m
Wouter Bos	m
Wouter De Vis	m
Wouter Koppen	m
Wouter Van Mechelen	m
Wouters	m
Wright	m
Wubbo	m
Wucherer	m
Wuyts	m
Wyatt	m
Wybrand	m
Wybren	m
Wyler	m
Wymeersch	m
Wynand	m
Wyneke	f
Xander	m
Xandra	f
Xaveer	m
Xaver	m
Xavi	m
Xavier	m
Xavier Jacobs	m
Xavier Malisse	m
Xaviera	f
Xeikon	m
Xenia	f
Xerxes	m
Xia	f
Xiang	m
Xiao	f
Xin	f
Xing	m
Xiu	f
Xuanzang	m
Xue	f
Y?ld?z	m
Yacine	m
Yadin	m
Yael	f
Yahya	m
Yair	m
Yakubu	m
Yamamoto	m
Yamna	f
Yan	m
Yang	m
Yanick	m
Yanina	f
Yanina Wickmayer	f
Yann	m
Yann Synaeghel	m
Yannick	m
Yannis	m
Yao Jie	f
Yaron	m
Yasar	m
Yasemin	f
Yaser	m
Yasin	m
Yasir	m
Yasmin	f
Yasmina	f
Yasmine	f
Yasser	m
Yasser Arafat	m
Yassin	m
Yassine	m
Yassir	m
Yates	m
Yazid	m
Yaël	f
Ybo	m
Ydo	m
Ye	m
Yeager	m
Yep	m
Yerfi	m
Yesim	f
Yeux Nébuleux	m
Yfke	f
Yge	m
Yigal	m
Yildiray	m
Yildirim	m
Yildiz	f
Yilmaz	m
Ying	f
Yiri	m
Yke	f
Ylona	f
Yma	f
Ymbault	m
Yme	m
Ymke	f
Ymte	m
Ynse	m
Yoel	m
Yoeri	m
Yoko	f
Yoko Ono	f
Yolanda	f
Yolande	f
Yolanthe	f
Yona	f
Yonah	m
Yonas	m
Yonathan	m
Yonina	f
Yora	f
Yoram	m
Yorgos	m
Yorick	m
Yoritomo	m
York	m
Yorke	m
Yoro	m
Yorrit	m
Yoshi	m
Yoshitoki	m
Younes	m
Young	m
Younis	m
Youp	m
Youp van 't Hek	m
Youri	m
Youssef	m
Youssouf	m
Yousuf	m
Ype	m
Ypke	m
Yuan Shao	m
Yudhoyono	m
Yuen	f
Yugi	m
Yuka	m
Yulu-Matondo	m
Yumi	f
Yundi Li	m
Yung	m
Yunus	m
Yuri	m
Yusef	m
Yussef	m
Yussuf	m
Yusuf	m
Yvan	m
Yves	m
Yves Leterme	m
Yves Saint Laurent	m
Yves Vanderhaeghe	m
Yvette	f
Yvon	f
Yvonne	f
Yücel	m
Yüksel	m
ZKH
Zaaf	m
Zabel	m
Zacharia	m
Zacharias	m
Zachary	m
Zack	m
Zafarin	m
Zafer	m
Zagrebber	m
Zagrebse	f
Zahir	m
Zalm	m
Zambiaan	m
Zambiaanse	f
Zambrotta	m
Zamorano	m
Zandwijk	f
Zane	m
Zapata	m
Zapatero	m
Zara	f
Zarah	f
Zavattaro	m
Zaïrees	m
Zaïrese	f
Zdenek Stybar	m
Ze Roberto	m
Zebulon	m
Zed	m
Zeeuw	m
Zeeuws-Vlaamse	f
Zeeuws-Vlaming	m
Zeeuwse	f
Zef	m
Zekeriya	m
Zeki	m
Zelaya	m
Zelfa	f
Zeni	f
Zeno	m
Zenobia	f
Zenon	m
Zetes	m
Zewlakow	m
Zhang	m
Zhao	m
Zheyun Ye	m
Zhu Xi	m
Zia	f
Ziad	m
Zico	m
Zidane	m
Ziegler	m
Zier	m
Zijad Jusic	m
Zijlmans	m
Zimbabwaan	m
Zimbabwaanse	f
Zimmerman	m
Zimmermann	m
Zinaïda	f
Zinedine	m
Zinedine Zidane	m
Zino	m
Zinédine	m
Zinédine Zidane	m
Zita	f
Zitka	m
Zizou	m
Zjirinovski	m
Zjoekov	m
Zlatan	m
Zlatan Ibrahimovic	m
Zlatko	m
Zoe	f
Zoetermeerder	m
Zoetermeerse	f
Zoff	m
Zofia	f
Zohra	f
Zoja	f
Zola	m
Zoltan	m
Zoltán	m
Zomer	f
Zoonlief	m
Zoran	m
Zorana	f
Zoroastrisme	m
Zorreguieta	m
Zoya	f
Zoë	f
Zuid-Afrikaan	m
Zuid-Afrikaanse	f
Zuid-Amerikaanse	f
Zuid-Hollander	m
Zuid-Hollandse	f
Zuid-Koreaan	m
Zuid-Koreaanse	f
Zuid-Tiroler	m
Zuid-Tiroolse	f
Zuko	m
Zulte Waregem	m
Zuola	f
Zuster	f
Zvonarjova	f
Zwaan	f
Zwart	m
Zwarte Leeuw	m
Zwarte Piet	m
Zwarts	m
Zweed	m
Zweedse	f
Zwering	m
Zwiers	f
Zwinkels	m
Zwitser	m
Zwitserse	f
Zwollenaar	m
Zwolse	f
aalmoezenier	m
aanbidder
aanbidster	f
aanbieder
aangeklaagde
aangever
aanhang	m
aanhanger
aanhangster	f
aanhouder
aanklaagster	f
aanklager
aannemer
aanspreekpunt
aanstaande
aansteller
aanstelster	f
aanstichter
aanstichtster	f
aanstoker
aanstookster	f
aanvaller
aanvoerder
aanvoerster	f
aanvrager
aanwezige
abdis	f
abonnee
aboriginal
abt	m
academica	f
academicus
accordeonist
accountant
achterban	m
achterblijfster	f
achterblijver
achterligger
achtervolger
acrobaat
acrobate	f
acteur
actieveling
actievoerder
activist
activiste	f
actor
actrice	f
acupuncturist
addergebroed
adel	m
adelborst
adjudant
administrateur
administratrice	f
admiraal
adolescent
adonis	m
adrian	m
adventist
adverteerder
adviseur
adviseuse	f
advocaat
advocaat-generaal
advocate	f
afgestudeerde
afgevaardigde
afgezant
afgod
afgodendienaar
afmaker
afneemster	f
afnemer
afperser
afstammeling
afstammelinge	f
afvallige
afwezige
afzender
afzendster	f
afzetster	f
afzetter
agent
agente	f
agitator
agnost
agnosticus
agoge	f
agoog
agrariër
agressor
aids	m
akela
al-Sadr	m
alchemist
alcoholist
alcoholiste	f
alfahulp
allah	m
alleenstaande
allochtoon
allrounder
alpinist
alpiniste	f
alt	f
alter ego
alternatieveling
altist
altruïst
altviolist
ama
amanuensis
amateur
amazone	f
ambachtsman	m
ambassadeur
ambassadrice	f
ambtenaar
ambtenares	f
anabaptist
analfabeet
analist
analiste	f
analyticus
anarchist
anarchiste	f
anatoom
andersdenkende
anderstalige
anesthesist
anesthesiste	f
anglicaan
anglist
anglofiel
animator
animatrice	f
ankerwacht
antagonist
antiquaar
antiquair
antirevolutionair
antisemiet
antropologe	f
antropoloog
antroposofe	f
antroposoof
apostel
apotheker
apothekeres	f
aquarellist
arabist
arbeider
arbeidsongeschikte
arbeidster	f
arbiter
archeologe	f
archeoloog
architect
architecte	f
archivaris
aristocraat
aristocrate	f
arme
armee	f
armoedzaaier
arrestant
arrestante	f
arrivist
artiest
artieste	f
artillerist
artistiekeling
arts
asceet
asielzoeker
asielzoekster	f
aso
aspirant
aspirante	f
assistent
assistente	f
astrologe	f
astroloog
astronaut
astronaute	f
astronoom
atheïst
atheïste	f
atleet
atlete	f
attaché
augustijn
augustines	f
auteur
autist
autochtoon
autodidact
avant-garde
avant-gardist
avonturier
avonturierster	f
ayatollah	m
baardaap	m
baas
babbelaar
babbelaarster	f
babbelkous
baboe	f
baby
babysit
back
bacterioloog
bader
baggeraar
bajesklant
baker	f
bakker
bakvis	f
baliekluiver
baljuw	m
ballerina	f
balling
ballonvaarder
bandiet
bangerd
bangerik
bankier
banneling
baptist
barbaar
barbier
bariton	m
barman	m
baron	m
barones	f
bas	m
basgitarist
bassist
bastaard
bataljon
bazin	f
beambte
bedeelde
bedelaar
bedelares	f
bedenker
bedevaartganger
bediende
bedoeïen
bedrieger
beeldhouwer
beeldsnijder
beenhouwer
begeleider
begijn	f
beginneling
beginner
begunstigde
begunstiger
behanger
behaviorist
behaviourist
beheerder
beiaardier
bejaarde
bejaardenhulp
bekeerde
bekeerling
bekende
bekendheid
bekerwinnaar
bekkenist
beklaagde
bekroonde
belager
belanghebbende
belangstellende
belegeraar
belegger
belhamel
belletrist
bemanning
bemiddelaar
beminde
bemoeial
benedictijn	m
benedictines	f
bengel
benjamin
benoemde
beoefenaar
beoordelaar
berijder
beroemdheid
beroeper
beschermeling
beschermer
beschouwer
beschuldigde
bestemmeling
bestrijder
bestuurder
betoger
betrokkene
betuttelaar
betweter
beul
beunhaas
beurtschipper
bevelhebber
bevindelijk-gereformeerde
bevindelijke
bevolking
bevrijder
bewaarder
bewaker
bewerker
bewindsman	m
bewindvoerder
bewonderaar
bewoner
bezetter
bezetting
bezitter
bezoek
bezoeker
bezorger
bibliofiel
bibliothecaresse	f
bibliothecaris
biechtvader	m
bieder
bierbrouwer
biersteker
bietser
bigamist
bijbelkring	m
bijzit	f
bijzitter
biljarter
bink	m
binnenvelder
binnenvetter
biochemicus
biograaf
bioloog
bisschop	m
blaag
blaaskaak
blaasorkest
blanke
blauwbaard	m
blauwhelm
blauwkous	f
blazer
bleekgezicht
bleekneusje
bleekscheet
blijver
blikslager
blinde
blindemannetje
blitskikker
bloedje
bloedverwant
bloemist
blonde
blondine	f
blondje
bluffer
bobo
bode
bodybuilder
bodyguard
boeddhist
boef
boefje
boekanier	m
boekbinder
boekenworm
boekenwurm
boeman	m
boemelaar
boer	m
boerin	f
boeteling
bofkont
bohémien	m
bokser
bolleboos
bolletjesslikker
bolsjewiek
bolsjewist
bomer
bon-vivant
bonk
bontwerker
boodschapper
bookmaker
boosdoener
booswicht
boots
bootsman	m
bootwerker
boreling
bosneger
boswachter
botanicus
botterik
bourgeois
bourgeoisie	f
bouwer
bouwkundige
bouwmeester
bouwvakker
boy	m
brandstichter
brandweerman	m
branieschopper
breakdancer
breister	f
brievenbesteller
brigadegeneraal
brigadier
broeder	m
broekie
broer	m
brombeer
bromfietser
brompot
broodwinner
brouwer
brugwachter
bruid	f
bruidegom	m
bruidspaar
brulaap
brulboei
brunette	f
bruut
buikspreker
buitenbeentje
buitenkerkelijke
buitenlander
buitenlandse	f
buitenstaander
buitenwacht
buitenwereld
bullebak	m
bultenaar
bureaucraat
burgemeester
burgemeesterse	f
burger
burgerbevolking
burgerij
burgerman	m
burgervader	m
burgerwacht
burggraaf	m
burggravin	f
butler	m
buur
cabaretier
cabaretière	f
cadet
caissière	f
calvinist
cameraman	m
canaille
captain
cardioloog
cartoonist
cast	m
causeur
cavalerist
cavalier	m
cellist
celliste	f
cembalist
censor
centrumdemocraat
centrumspits
chansonnier	m
chansonnière	f
chanteur
chaoot
chaperon	m
chaperonne	f
charlatan
charmeur	m
chauffeur
chauffeuse	f
chauvinist
chauviniste	f
chef
cheffin	f
chemica	f
chemicus
cherubijn	m
chirurg
choreograaf
choreografe	f
christen
christen-democraat
cijferaar
cimbalist
cineast
cineaste	f
cinefiel
cipier
cisterciënzer	m
classica	f
classicus
clavecinist
clerus	m
clientèle
clinicus
cliënt
cliënte	f
clown
co
coach
coiffeur
collaborateur
collectant
collectiviteit
collega
colporteur
columnist
combo
commandant
commandeur
commandotroepen	m
commentator
commentatrice	f
commies
commissaris
communicant
communist
compagnon
componist
componiste	f
conciërge
concubine	f
concurrent
concurrente	f
conducteur
conductrice	f
conferencier
confessionelen
conformist
confrater	m
congresganger
connaisseur
conrector
conservatief
conservator
conservatrice	f
consorten
constructeur
consul
consul_generaal
consulent
consulente	f
consultant
consument
contactpersoon
contrabassist
contrapuntist
contribuant
controleur
controleuse	f
copiloot
corrector
correctrice	f
correspondent
correspondente	f
coryfee
countertenor	m
coureur
cowboy	m
coördinator
coördinatrice	f
crapuul
creationist
crediteur
crew	p
crimineel
criminologe	f
criminoloog
criticaster
criticus
croupier
curator
curatrice	f
cursist
cursiste	f
cynicus
dadaist
dader
daderes	f
dakloze
dame	f
dameskapper
dammer
dandy	m
danser
danseres	f
dansmarieke	f
darwinist
datatypist
datatypiste	f
dealer
debiel
debiteur
debutant
debutante	f
decaan
deelneemster	f
deelnemer
degenslikker
dekhengst	m
del	f
delegatie	p
delinquent
demagoog
democraat
demonstrant
demonstrante	f
denker
dermatoloog
dertiger
deserteur
designer
deskundige
desperado
despoot
detaillist
detective
determinist
deugniet
deurwaarder
dewinter	m
diabeet
diabete	f
diabeticus
diacones	f
diaken	m
dialectspreker
diamantair
dichter
dichteres	f
dictafoniste	f
dictator
dief
dienaar
dienares	f
diender
dienstbode	f
dienster	f
dienstklopper
dienstknecht	m
dienstmeisje
dienstplichtige
dievegge	f
dikkerd
dikzak
dilettant
dilettante	f
diplomaat
directeur
directeur_generaal
directrice	f
dirigent
dirigente	f
discipel
discuswerper
diskjockey
dissident
dissidente	f
distributeur
diva	f
diëtist
diëtiste	f
docent
docente	f
dochter	f
dochterlief	f
doctor
doctoranda	f
doctorandus
documentalist
documentarist
dode
doe-het-zelver
doelman	m
doener
doerak
doetje
doge	m
dogger	m
dogmatist
dokter
dokteres	f
dokwerker
dolleman	m
domina	f
dominee
domineese	f
dominicaan	m
dominicanes	f
domoor
dompteur
dompteuse	f
donateur
donatrice	f
donor
doodgraver
doodseskader
doodsvijand
doopmoeder	f
doopsgezinde
doorbijter
doordenker
doordouwer
doorjager
doorzetster	f
doorzetter
dorpeling
dorpelinge	f
dorper
douane
douanier
dove
draaikont
drager
dragonder	f
dramaturg
drankorgel
drenkeling
dresseur
dressman	m
dreumes
drieling	m
drieman	m
driemanschap
drietal
driftkikker
driftkop
drijfnetvisser
drinkebroer
drogist
dromer
drommel	m
dronkaard
dronkelap
droogkloot
droogkomiek
droogstoppel
droomprins	m
droomster	f
drop-out
drost	m
druiloor
druivenplukker
drukker
drumband	m
drummer
drumster	f
druïde	m
dubbelganger
dubbelgangster	f
dubbelspion
duiker
duikster	f
duimelot
duivel	m
duivel-doet-al
duivelin	f
duivenmelker
duo
duopassagier
dupe
durfal
duts
duvelstoejager
dwaas
dwarsligger
dweepster	f
dweper
dwerg
dwingeland
echtbreekster	f
echtbreker	m
echtelieden	m
echtpaar
ecoloog
econome	f
econometrist
economist
econoom
edele
edelman	m
edelsmid
eega
eenling
eerstejaars
eersteling
egotripper
egoïst
egoïste	f
eigenaar
eigenares	f
eigenheimer
eikel	m
eilander
eiser
eiseres	f
electoraat
elektricien
elektromonteur
elftal	g
elite	f
ellendeling
embryoloog
emigrant
emir	m
empirist
employee	f
employé
encyclopedist
enfant terrible
engel
engerd	m
enkeling	m
enquêteur
enquêtrice	f
entertainer
epicurist
epigoon
epileptica	f
epilepticus
episcopaat
eregast
erfgenaam
erfgename	f
erflater
erfpachter
esperantist
essayist
establishment
estheticus
etaleur
etaleuse	f
eter
etherpiraat
etter	m
eunuch	m
europarlementariër
evacuee	f
evacué
evangelist
evangeliste	f
evolutionist
ex
examinator
examinatrice	f
excentriekeling
exhibitionist
existentialist
exorcist
expediteur
expert
exploitant
expressionist
extremist
fabrikant
factotum
fagottist
fagottiste	f
fakir	m
fakkeldraagster	f
fakkeldrager	m
falangist
familie	p
fan
fanaat
fanate	f
fanaticus
fanatiekeling
fantast
fantaste	f
farao	m
farmaceut
farmer
fascist
fat	m
federalist
fee	f
feeks	f
feestganger
feestvarken
feestvierder
feestvierster	f
femelaar
femelaarster	f
feminist
feministe	f
femme fatale	f
fetisjist
fietser
fietsster	f
figurant
figurante	f
fijnproever
filantroop
filatelist
filmer
filmkijker
filmster
filosofe	f
filosoof
finalist
financier
firmant
firmante	f
fiscaal-jurist
fiscaaljurist
fiscalist
flamingant
flapdrol
flapuit
flauwerd
flauwerik
flessekind
flessenkind
flessentrekker
flierefluiter
flik	m
flikker	m
flinkerd
florettist
fluisteraar
fluitist
fluitiste	f
foerier
fokkenist
fokkenmaat
fokker
folklorist
foneticus
fonoloog
forens
formalist
formateur
fortuinzoeker
fortuinzoekster	f
foster parent	m
fotograaf
fotografe	f
fotojournalist
fotomodel
franciscaan	m
franciscanes	f
francofiel
franskiljon	m
frater	m
fraudeur
freak
freelancer
freule	f
frik
functionaris
fundamentalist
futurist
fysicus
fysiotherapeut
gabber	m
gajes
galeislaaf	m
galgenaas
gallicist
gangster
gangsterbende
ganzenhoeder
gaper	m
gardist	m
garnalenvisser	m
garçon	m
gasfitter
gast
gaste	f
gasten
gaucho	m
gaullist
geadresseerde
geaggregeerde
geallieerden	m
geassocieerde
gebedsgenezer
gebedsgenezeres	f
gebochelde
geboefte
gebr.	m
gebroeders	m
gebruiker
gecommitteerde
gedaagde
gedelegeerde
gedeporteerde
gedeputeerde
gedetineerde
gediplomeerde
gedupeerde
geest	m
geestdrijver
geestelijke
geestelijkheid	f
geesteskind
geestverschijning	f
geestverwant
gegadigde
gegijzelde
gehandicapte
gehuwde
geisha	f
geitenbreier	m
geitenhoeder	m
gek
geleerde
gelegenheidsdrinker
geleide
geleider	m
geliefde
gelieven
gelijke
gelijkgezinde
gelovige
gelukkige
geluksvogel
gelukzoeker
gemaal	m
gemachtigde
gemalin	f
gematigde
gemenerik
gendarme	m
geneeskundige
generaal	m
generalist
geneticus	m
genezer	m
genie
geniesoldaat	m
genieter
genodigde
genoot
genote	f
gentleman	m
geograaf
geoloog
gepensioneerde
gepeupel
gerant
gereformeerde
germanist
germaniste	f
gesneuvelde
gespuis
gestorvene
gestrafte
geteisem
getroffene
getrouwe
getuige
geus
gevangenbewaarder
gevangene
gever
gevolg
gevorderde
geweldenaar
gewetensbezwaarde
gewichtheffer
gewonde
gewoontedier
gezagdrager
gezaghebber
gezagsdrager
gezagvoerder
gezagvoerster	f
gezant
gezantschap
gezel
gezelligheidsdier
gezellin	f
gezusters	f
gezworene
geënquêteerde
geïnteresseerde
geïnterviewde
gids
giechel
gier
gierigaard
gifmenger
gifmengster	f
gigant
gigolo	m
gijzelaar
gitarist
gladakker	m
gladiator	m
gladjanus	m
glastuinder
glazenwasser
globetrotter
gluiperd
gluurder
gnoom
god
godenzoon	m
godheid
godin	f
godsdienstfanaat
goedzak
goegemeente	f
goeierd
goeroe
gokker
gokverslaafde
golfer
gondelier
goochelaar
goochemerd
goudsmid
goudzoeker
gourmet
gouvernante	f
gouverneur
gozer	m
graaf	m
graficus
grafoloog
grammaticus	m
grande	m
grapjas
gravin	f
grenadier	m
grenswacht
griet	f
griezel	m
griffier
grijsaard	m
grimeur
groentje
groep	p
grootheid
grootje
grossier
groupie	f
grutter
guerrilla
guerrillero
guit
gulzigaard
gymnasiast
gymnast
gynaecoloog
haaibaai	f
haantje-de-voorste
hairstylist
halfbloed
halfwas
handelaar
handenbinder
handlanger
happy few
harpenist
harpist
hazenhart
headhunter
hebberd
hedonist
heemraad
heer	m
heeroom	m
heerschap	m
heerser
heiden
heidin	f
heikneuter
heilige
heilsoldaat
heks	f
held
helderziende
heldin	f
heler
hellenist
helleveeg	f
helper
hengelaar
henin	f
heraut
herbarist
herbergier
herborist
herder
herderin	f
hermafrodiet
hernhutter
heroïnehoer	f
herrieschopper
hersteller
hertog	m
hertogin	f
hervormde
hervormer
hervormingsgezinde
hetero
heterofiel
heteroseksueel
hielenlikker
hijger	m
hindoe
hinkepoot
hippie
hispanist
historicus
hitler	m
hobbyist
hoboïst
hoeder
hoefsmid
hoer	f
hogepriester
hogere
homeopaat
homo	m
homofiel
homoseksueel
hondenlul	m
hongerstaker
honnepon
hoogheid
hoogleraar
hoogvlieger
hoogwaardigheidsbekleder
hooligan
hoornist
hopman	m
horige
hospik
hospita	f
hospitant
hostess	f
hotelier
houder
houdster	f
houthakker
houtvester
hoveling
hovenier
hufter	m
hugenoot
huichelaar
huidvetter
huilebalk
huishoudster	f
humanist
hummel
humorist
huurder
huurling
hypnotiseur
hypochonder
hypocriet
hystericus
iconoclast
idealist
idioot
idool
ijdeltuit
ijlbode
ijscoman	m
ijszeiler
ijveraar
ijzervreter
ik
ikfiguur
illegaal
illusionist
illustrator
imam	m
imbeciel
imitator
imker
immigrant
immunoloog
imperialist
importeur
impresario
impressionist
inboorling
inbreker
inciviek
incrowd
individu
individualist
indringer
industrieel
infanterist
infiltrant
informant
informateur
informaticus
informatiebron
ing.
ingenieur
ingewijde
ingezetene
initiatiefnemer
inkoper
inlander
inleider
inquisiteur
insider
insluiper
inspecteur
inspirator
installateur
instructeur
instrumentalist
instrumentist
intekenaar
intellectueel
intelligentsia	f
intendant
intercedent
interim
interimaris
intermediair
international
internist
interviewer
intimus
intrigant
introducee	f
introducé
invalide
invaller
investeerder
inwijkeling
inwoner
inzender
inzittende
ir.
islamiet
jager
jaknikker	m
janmaat	m
jantje
jarige
jennifer	f
jeugd
jezuïet	m
joch
jochie	m
jockey
jodelaar
jodenhater
jogger
jokkebrok
jongedame	f
jongeheer	m
jongeling	m
jongelui
jongeman	m
jongen	m
jongere
jongetje	m
jongleur
jongvolwassene
jonker	m
jonkheer	m
jood
journalist
joyrider
jubilaris
judas
judoka
juf	f
juffertje	f
juffrouw	f
junior
junkie
jurist
jury
juwelier
kabouter
kaffer
kakelnestje
kakmadam	f
kalief	m
kamenier
kamenierster	f
kameraad
kamikaze	m
kampbeul
kampeerder
kampioen
kandidaat
kanjer
kankeraar
kannibaal
kanovaarder
kanselier	m
kanshebber
kanunnik	m
kapelaan	m
kaper
kapitalist
kapitein
kapper
kapster	f
kardinaal	m
karikaturist
karmeliet	m
karmelietes	f
karrenman	m
kartuizer	m
kartuizerin	f
kasplantje
kassier
kastelein
kasteleinse	f
katholiek
kattenmepper
keeper
keikop
keizer	m
keizerin	f
kelner	m
kenau	f
kenner
kerel	m
kerkvader	m
ketelaar	m
ketelbink	m
ketter
keukenmeid	f
keukenprins	m
kidnapper
kiesgerechtigde
kiezer
kikvorsman	m
kind
kindskind
kinesist
kinesitherapeut
kinkel	m
klaar-over
klaas	m
klant
klantenkring	m
klarinettist
klavecinist
kleine
kleptomaan
klerelijer	m
klerk
klets
kletskop
kletskous
kletsmajoor
kletsmeier
kleurling
kleuter
kliek
klier
klikspaan
klimmer
kloosterling
klootzak	m
kluizenaar
klungel
kluns
klusjesman	m
knaap	m
knakker	m
knapperd
knecht
kneus
knibbelaar
knoeier
knoeipot
knokploeg
knorrepot	m
knul	m
knurft
knutselaar
kobold
koekenbakker
koelie
koerier
koetsier
koffieleut
kok
kokkin	f
kolonel
koloniaal	m
kolonist
komediant
komiek
kompel	m
kongsi
koning	m
koningin	f
koningin-moeder	f
koningin-regentes	f
konkelaar
kooiker
koopman
koperslager
kopiist
kopman	m
korfballer
kornettist
kornuit	m
korporaal
kosmonaut
kosmopoliet
koster
kosteres	f
kostganger
kostwinner
koter
kotmadam	f
koukleum
kozak	m
kraamhulp
krabber
krachtpatser	m
kraker
kramer
krankzinnige
kreng
krentenkakker
krentenweger
krieltje
krijger
kroongetuige
kroonpretendent
kroonprins	m
kroonprinses	f
kroost
kruidenier
kruier
kruisvaarder
krullenbol
kubist
kunstenaar
kwaaie
kwajongen	m
kwakkelaar
kwakzalver
kwebbel
kwek
kwekeling
kweker
kwelduivel
kwezel
kwibus
kynoloog
laatbloeier
laatkomer
laatstgenoemde
laborant
lachebek
lacher
lady	f
ladykiller	m
lafaard
lafbek
lakei	m
lamme
lammeling
lamzak	m
landadel	m
landingstroepen
landmeter
landrot
langlaufer
langslaper
langstlevende
lansier
lapzwans	m
lasser
lastgever
lastpak
lastpost
latinist
laureaat
lector
lectrice	f
leeghoofd
leek
leerkracht
leerling
leerlinge	f
leerlooier
leesmoeder	f
leeuwentemmer
lefgozer	m
legionair	m
leider
leidersfiguur
leidsman	m
leidster	f
lekkerbek
lekkerbekje
lelijkerd
lellebel	f
lener
leninist
leperd
lepralijder
leproos
leraar	m
lerares	f
lesbienne	f
lesbo	f
letterkundige
leugenaar
levensgenieter
leverancier
lexicograaf
lexicoloog
lezer
liberaal
libero
libertijn
librettist
licentiate	f
lichtekooi	f
lichtgewicht
lichtmatroos
lid
lidmaat
lieden
lief
liefhebber
liefje
liefste
liegbeest
lieveling
lieverd
liftboy	m
lifter
lijder
lijfeigene
lijfwacht
lijkbidder
lijkenpikker
lijntrekker
lijp
lijpo
lijstduwer
lijsttrekker
lilliputter
linguïst
linksachter
linksback
linksbinnen
linksbuiten
linkshalf
linksvoor
literator
lobbes	m
lobby	m
lobbyist
loeder
logicus
logopedist
logé
lokettist
lolbroek
lomperd
lomperik
loodgieter
loontrekkende
loontrekker
loper
losbol
lui
luierik
luilak
luisteraar
luistervink
luitenant
luitenant-generaal
luitenant-kolonel
luitenant-ter-zee
luitist
luitjes
luiwammes
lul	m
lummel	m
lustobject
lutheraan
lyceist
ma	f
maagd
maarschalk
maat
maatje
machinist
macho	m
machthebber
machtsdrager
machtswellusteling
madam	f
madonna	f
maestro	m
maffia
maffioso	m
mafkees
magazijnier
magistraat
magiër
magnaat
magnetiseur
maharadja	m
majoor
majorette	f
makelaar
maker
makker
malloot
mam	f
mama	f
mammon	m
man	m
manager
mandataris
mandolinist
maniak
manipulator
maniërist
mannequin
mannetje
mannetjesputter
manschappen
manusje-van-alles
marconist
marineofficier
marinier
markies	m
markiezin	f
marskramer	m
martelaar
marva	f
marxist
masochist
masseur
matador
matchwinnaar
materialist
matrone	f
matroos
mazzelaar
maîtresse	f
mecanicien
mecenas
medaillewinnaar
medewerker
mediaevist
medicijnman	m
medicus
meerdere
meerling	m
meester	m
meesteres	f
megaster
meid	f
meisje	f
mejuffrouw	f
melkmuil	m
meneer	m
menist
mens
mensheid	f
mensjewiek
mentor
messias
mesties
meteoroloog
metgezel
methodist
metropoliet	m
metselaar
mevrouw	f
middeleeuwer
middenkader
middenstand	m
middenstander
middenvelder
midvoor
mietje
migrant
mijnwerker
milicien	m
militair
militarist
miljardair
miljonair
milva	f
mindere
minderjarige
miniemen
minima
minister
minister_president
minkukel
minnaar	m
minnares	f
minstreel	m
misantroop
misbaksel
misdadiger
misdienaar	m
mispunt
miss	f
missionaris	m
modeontwerper
moderator
modernist
moeder	f
moeder-overste	f
mof
mohammedaan
mokkel
molenaar
monarch
monarchist
mongool
monnik	m
monseigneur	m
monteur
moor
moordenaar
moralist
mormoon
morspot
moslim
mosselvisser
mr.
muggenzifter
mulat
mulattin	f
multimiljonair
mummie
musicoloog
musicus
musketier
muurbloempje
muze	f
muzelman
muzikant
mysticus
na-aper
naaister	f
naakt
naamgever
naarling
naaste
nabestaande
nachtbraker
nachtploeg
nachtwacht
nageslacht
nakomeling
nakomelingschap	f
nakomertje
nar
narcist
narcotiseur
nationaal-socialist
nationalist
naturalist
naturist
navelstaarder
navigator
navolger
nazaat
nazi
naïeveling
necrofiel
neef	m
neerlandicus
negativist
negentiger
neger
negerbevolking	f
negerin	f
negerslaaf
neofascist
neonazi
nepper
neringdoende
nestor	m
neuroloog
neuroot
neuroticus
nicht
nietsnut
nieuweling
nieuwkomer
nieuwlichter
nihilist
nijdas
nikker
nimf	f
nitwit
nomade
non	f
non-conformist
nonkel	m
noodslachter
noorderbuur	m
noorderling
norbertijn	m
normalist
notabele
notaris
notulist
nouveau riche
novellist
novice
nozem	m
nudist
nuf	f
nuntius	m
nymfomane	f
obama	m
ober	m
obligaat
observator
obstructionist
occultist
oceaanzeiler
oceanograaf
oculist
oelewapper
oen
official
officier
oma	f
ombudsman
ome	m
omroeper
omroepkoor
omroeporkest
omroepster	f
omroepvoorzitter
omstaander
omstander
omwonende
onafhankelijkheidsbeweging	f
onbekende
onbenul
onbevoegde
oncoloog
onderdaan
onderdeurtje
onderdrukker
onderduiker
ondergeschikte
ondergetekende
onderhandelaar
onderkruiper
onderkruipsel
ondernemer
ondertekenaar
ondervraagde
ondervrager
onderwereldfiguur
onderwijzer
onderwijzeres	f
onderzoeker
ongeletterde
ongelovige
onheilsbode
onheilsprofeet
onmens
onnozelaar
onruststoker
onrustzaaier
onschuldige
ontdekker
onthaalmoeder	f
ontheemde
ontvoerder
ontwerper
ontwikkelaar
ontwikkelingswerker
onverlaat
oogappel
oom	m
oomzegger
oosterling
opa	m
opdonder
opdondertje
opdrachtgever
operateur
operator
opiumschuiver
opkoper
oplichter
oploop	m
opoe	f
oppas
oppasser
opperhoofd
opperman	m
opponent
opportunist
oprichter
oproerkraaier
opschepper
opsnijder
opstandeling
opsteller
opticien
optimist
opvarende
opvoeder
opvoedkundige
opvolger
opzichter
orangist
orator
ordetroepen
ordonnans
organisator
organist
orgeldraaier
orgelman	m
oriëntalist
orkest
orkestbode
ornitholoog
orthodontist
orthopedagoog
orthopedist
orthopeed
oude
ouder
oudere
ouderejaars
ouderling
ouderpaar
oudgediende
oudje
oudste
outcast
outsider
ouvreuse	f
ouwe	m
ouwehoer
overblijver
overbuur
overheerser
overledene
overlevende
overloper
overste
overtreder
overvaller
overwinnaar
overwinteraar
pa	m
paap
pachter
pacifist	m
padvinder	m
padvindster	f
pagadder	m
paganist	m
page	m
paladijn	m
paleiswacht	m
paleograaf
paleontoloog	m
paljas
pallieter	m
pamflettist
panel
panfluitist
paniekzaaier
pantheïst
pantheïste	f
pantoffelheld
pap	m
papa	m
papendom
papenvreter
papist
papkind
pappa	m
pappie	m
paps	m
papzak
parachutist
paracommando
paradepaardje
paragnost	m
paranimf
paratroepen
parelduiker
parelduikster	f
paria
parkeerwacht
parkeerwachter
parketwacht
parkwachter
parlementair
parlementariër
parochiaan
participant
particulier
partizaan
partner
parttimer
parvenu
pasja	m
passagier
passant
passionist
pastoor	m
pastor
pater	m
patholoog
patholoog-anatoom
patiënt
patriarch	m
patriciër
patriot
patrones	f
patroonheilige
patser	m
paukenist
pauper
paus	m
pechvogel
pedagoog
pederast	m
pediater
pedofiel
pelgrim
pelotonscommandant
pelsjager
pendelaar
pennenlikker
penoze
pensionaris	m
pensiongast
penvoerder
percussionist
percussioniste	f
perfectionist
persmuskiet
persona non grata
personage
personeel
persoon
persoontje
pessimist
pestbuil
pestkop
petekind
petemoei	f
peter	m
petomaan
peuter
pianist
pianiste	f
pianobouwer
pianoleraar
pianolerares	f
pianostemmer
pias
piccolo	m
pief	m
piekeraar
pierewaaier
pierrot
piet	m
pieterman	m
pietlut
pijproker
pikeur
pikkie	m
piloot
pimpelaar
pin-up	f
pineut
pionier
piraat
pispaal
pitcher
plaaggeest
plaatsvervanger
plager
plakker
planner
planoloog
planter
playboy	m
plebejer
plebs
pleitbezorger
pleiter
pleurislijder
ploert	m
ploeteraar
plukker
plunderaar
poelier
pointillist
pokkenlijder
polak
polemist
polemoloog
politica	f
politicoloog
politicus
politieman	m
polyglot
ponstypist
pooier	m
poorter
popartiest
pope	m
popster
populist
poseur
positivist
postiljon	m
postmodernist
potentaat
potloodventer	m
pottenbakker
pottenkijker
poëet
pragmaticus
pragmatist
prater
predikant
prediker
prefect	m
prelaat	m
premiejager
premier
presbyteriaan
presentator
presentatrice	f
preses
president
pretendent
priester	m
priesteres	f
prijswinnaar
prima donna	f
primitief
primus inter pares
prins	m
prins-gemaal	m
prinses	f
prior
pro-Deoadvocaat
procureur
procureur-generaal
producent
producer
proefkonijn
proefpersoon
prof
prof.
profbokser
profeet
professional
professor
profiteur
programmeur
proleet
proletariaat
proletariër
prominent
promotor
promovenda	f
promovendus
propje
prostituee	f
protagonist
protectionist
protestant
protégee	f
protégé
provinciaal
provo
provocateur
provoost
prutser
psalmdichter
psalmist
psychiater
psychoanalyticus
psycholoog
psychometrist
psychoot
psychopaat
psychotherapeut
puber
publicist
publiek
puinruimer
puk
pummel	m
punker
purist
puritein
purser
puzzelaar
pygmee
pyromaan
quaestor
quaestrix	f
querulant
quizmaster
raadgever
raadsman	m
rabauw
rabbi	m
rabbijn	m
racist
raddraaier
radicaal
radioloog
radja	m
raio
rakker
randfiguur
randgroepjongere
rangeerder
rapaille
rapporteur
rasartiest
rasegoïst
raspaardje
rasta
rationalist
rattenvanger
reactionair
reader
reageerbuisbaby
realist
rebel
recensent
receptionist
receptioniste	f
rechercheur
rechter
rechter_commissaris
rechterhand
rechthebbende
rechtsachter
rechtsback
rechtsbinnen
rechtsbuiten
rechtshalf
rechtsvoor
recidivist
recreant
rector	m
rector magnificus
rectrix	f
redacteur
redactrice	f
redder
reddingswerker
redenaar
reder
rederijker
referee
referent
reflectant
reformator
reformist
refugié
regelaar
regelneef
regent	m
regentes	f
regisseur
reisgezel
reiziger
rekenaar
rekenwonder
rekkelijke
rekruut
rekwisiteur
religieus
religieuze	f
relschopper
reltrapper
remedial teacher
remigrant
remmer
remonstrant
renner
rennersveld	p
rentenier
reparateur
repatriant
repetitor
reporter
representant
republikein
reservist
resident	m
respondent
restaurateur
reus
reuzekerel	m
reuzin	f
revisionist
revisor
revolutionair
reünist
ridder	m
rijder
rijkaard
rijke
rijkelui
rijkeluiskind
rijkswachter
rijmelaar
ripper	m
risee
ritmesectie	f
ritselaar
rivaal
rivale	f
roadie
robbedoes
rocker
roddelaar
rode
roeier
roerganger
roetmop
roker
rokkenjager	m
rolbezetting	f
romancier
romancière	f
romanfiguur
romanist
romanticus
ronselaar
roodhuid
roofridder	m
rot
rotjoch	m
rotjong	m
rotmeid	f
rotvent	m
routinier
rover
roversbende
rowan	m
royalist
royalty
ruimtevaarder
ruiter
ruitertje
runner
runner-up
rus
ruziezoeker
saboteur
sadist
sadomasochist
saloncommunist
salonsocialist
samensteller
samenzweerder
samoerai	m
sandinist
sandwichman	m
sanskritist
sarcast
satiricus
saxofonist
scenarist
scepticus
schaapherder
schaatser
schade-expert
schaker
schalk
schandknaap	m
schandvlek
schansspringer
schare
scharensliep
scharenslijper
scharminkel
scharrel
scharrelaar
schat
schatbewaarder
schatgraver
schattebout
schavuit
scheikundige
schelm
schenker
schepen
schepper
scherpslijper
schertsfiguur
schijterd
schilder
schildknaap	m
schildwacht
schipbreukeling
schipper
schipperse	f
schizofreen
schlemiel
schnabbelaar
schobbejak	m
schoelje
schoenlapper
schoenpoetser
schoffelaar
schoffie
schoft	m
scholier
schone	f
schooier
schorem
schorriemorrie
schout
schout-bij-nacht
schreeuwerd
schreeuwlelijk
schrijfster	f
schrijnwerker
schrijver
schrobber
schrokop
schuimer
schuinsmarcheerder
schuldeiser
schuldenaar
schuldige
schurk
schutspatroon
schutter
scout
scribent
scriptgirl	f
secondant
secretaresse	f
secretaris
secretaris-generaal
seigneur	m
seinwachter
seismoloog
sekreet
seksbom	f
seksist
seksmaniak
sekssymbool
seksuoloog
seminarist
semitist
senator
senior
sensatiezoeker
separatist
serafijn	m
sergeant
sergeant-majoor
serveerster	f
sheriff
sherpa
showbink	m
showman	m
sinjeur	m
sinjoor
sinoloog
sint
sjacheraar
sjah	m
sjamaan	m
sjeik	m
sjiiet
sjoemelaar
sjouwer
skileraar
skinhead
skiër
slaaf
slaapkop
slaapwandelaar
slachter
slachtoffer
slager
slagersknecht
slagman
slagwerker
slampamper
slangenbezweerder
slaper
slapie
slapjanus
slappeling
slavendrijver
slavin	f
slavist
slechterik
slechtziende
sleper
slet	f
sleutelfiguur
sleutelkind
slijmbal
slijmerd
slijter
slimmerd
slimmerik
slippendrager
sloddervos
sloeber
sloerie	f
slokop
slons
sloof	f
sloper
sluiswachter
sluiter
slungel
smeerkees
smeerlap
smeerpijp
smeerpoets
smekeling
smeris
smid
smiecht
smokkelaar
smulpaap
snaak	m
sneeuwman	m
sneeuwruimer
snelheidsduivel
snelwandelaar
snertvent	m
snijder
snob
snoeper
snoes
snoeshaan
snoever
snol	f
snoodaard
snotaap
snotneus
snuffelaar
snuiter	m
snuiver
snul
sociaal-democraat
sociaal-liberaal
socialist
sociolinguïst
socioloog
sodeflikker
sodemieter	m
soenniet
soeverein
sofist
softenonkind
soldaat
solist
sollicitant
somnambule
sopraan	f
souffleur
souschef
souteneur	m
spaarder
spaghettivreter
specialist
speculant
speelkameraad
speelman	m
speelster	f
speelvogel
speerwerper
spelbreker
speleoloog
speler
spelverdeler
speurder
spicht
spijbelaar
spijtoptant
spion
spits
spleetoog
splintergroepering	f
sponsor
sportman	m
spraakwaterval
spreekbuis
spreker
spring-in-'t-veld
springruiter
sprinter
spuiter
spuitgast
squaw	f
sta-in-de-weg
staatsman	m
stagiair
staker
stakingbreker
stakingspost	m
stakker
stalinist
stalknecht
stand-in
standwerker
star
starter
statisticus
stayer
stedeling
steelband	m
steenbakker
steenhouwer
stemgerechtigde
stemmer
stempelaar
stenotypist
sterrenkundige
sterrenwichelaar
sterveling
steuntrekker
steve	m
steward	m
stewardess	f
stichter
stichtingsbestuur
stiekemerd
stierenvechter
stijfkop
stilist
stille
stinkerd
stoeipoes	f
stoethaspel
stoffeerder
stoker
stomkop
stomme
stommeling
stommerik
stommetje
stoottroepen	m
stopper
stotteraar
stouterd
stouterik
stoïcijn
straatveger
strandjutter
strandwacht
strateeg
streber
strijder
strijker
strijkje
strijkorkest
stripper
stroman
strooplikker
stroopsmeerder
stroper
structuralist
student
studente	f
stukadoor
stumper
stuntelaar
stuntman	m
stuntvlieger
stuurman	m
stuwadoor
subtopper
sufferd
suffragette	f
suikeroom	m
sujet
sukkel
sukkelaar
sul
sultan	m
superieur
superopportunist De Gught	m
superstar
supervisor
suppoost
supporter
surfer
surrealist
surrogaatmoeder	f
surveillant
symbolist
sympathisant
syndicalist
taalkundige
tachtiger
tacticus
takkelijer	m
talenwonder
talmoedist
talmudist
tamboer
tante	f
tatoeëerder
taxateur
team
techneut
technicus
technocraat
technoloog
teenager
tegelzetter
tegenbeweging	f
tegenhanger
tegenstander
tegenstemmer
tegenstrever
tegenvoeter
tekenaar
telefonist
telegrafist
teler
teller
temmer
tempelier	m
tennisser
tenor	m
teringlijder
teringlijer
terrorist
testpiloot
teut
theeleut
theoloog
theoreticus
theosoof
therapeut
thuiswerker
tiener
tijdopnemer
timmerman	m
tipgever
tippelaarster	f
tiran
titan	m
titularis
tobber
toehoorder
toerist
toeschouwer
toetsenist
toeverlaat
tolbeambte
tolk
tolk-vertaler
tollenaar	m
tommy	m
toonder
toondichter
topman	m
topper
topscorer
toreador
torero
totaalweigeraar	m
touroperator
touwslager
tovenaar
tovenares	f
toverheks	f
toverkol	f
traditionalist
trainee
trainer
traiteur
transseksueel
trapezewerker
trappist	m
travestiet
trawant
trendsetter
trendvolger
treurdichter
treuzelaar
triatlonatleet
trien	f
trimmer
trisser
troel	f
troela	f
troepenmacht
troetelkind
trol
trombonist
trommelaar
trompetter
trompettist
troonopvolger
troonpretendent
trotskist
troubadour	m
trucker
trut	f
tsaar	m
tsarina	f
tuinder
tuinier
tuinman	m
turner
tut	f
tuthola	f
tuttebel	f
tuut
twen
twijfelaar
twintiger
typist
typiste	f
typograaf
uitbaatster	f
uitbater
uitblinker
uitbuiter
uitdager
uitgewekene
uitkeringsgerechtigde
uitkeringstrekker
uitlegger
uitslover
uitvaller
uitverkorene
uitvinder
uitvoerder
uitvoerende
uitvreter
uitzendkracht
uitzuiger
ultra
ultranationalist
umpire
undercoveragent
underdog
unitarist
uroloog
usurpator
utilitarist
utopist
uurloner
va	m
vaandeldrager
vaandrig
vader	m
vaderfiguur	m
vaderskind
vagant
vagebond
vakantieganger
vakman	m
valkenier
valsaard
valschermspringer
valsemunter
valserik
vamp	f
vampier
van Roosbroeck	m
vandaal
vanger
vastgoedmakelaar
vazal	m
vechter
vechtjas
vechtmachine
vedergewicht	m
vedette
veelvraat
veerman	m
veertiger
veganist
veger
vegetariër
veldheer	m
veldwachter	m
vendelier
vennoot
vent	m
venter
ventriloquist
verantwoordelijke
verbalisant
verbruiker
verdachte
verdediger
verdeler
vereffenaar
vergader_tijger
vergeetal
verhuizer	m
verhuurder
verkeersdode
verkenner
verklikker
verkoopster	f
verkoper
verkrachter	m
verleider
verliezer
verloofde
verloskundige
verlosser
vermiste
vernieler
vernieuwer
veroordeelde
veroorzaker
veroveraar
verpleegkundige
verpleegster	f
verpleger
verrader
verschoppeling
versierder
verslaafde
verslaggever
verspieder
verspringer
verstaander
verstekeling
vertaler
vertegenwoordiger
verteller
vertolker
vertrouweling
vertrouwensman	m
vervalser
vervanger
vervoerder
vervolger
vervuiler
verwant
verwekker
verwerker
verzamelaar
verzekeraar
verzekerde
verzoeker
verzorger
veteraan
vetzak
vibrafonist
vicaris	m
vice-premier
vice-president
vice-voorzitter
viespeuk
viezerd
viezerik
vijand
vijandin	f
vijfenzestigplusser
vijftigplusser
viking
vinder
violist
violoncellist
vioolbouwer
virtuoos
visagist
visagiste	f
visionair
visser
vitter
vizier	m
vlegel	m
vleier
vlerk	m
vliegenier
vlootvoogd
vluchteling
vocalist
voddenman	m
voddenvent	m
voedster	f
voerman	m
voetballer
voetganger
vogelaar
vogelvrijverklaarde
vogelwachter
volgeling
volger
volksdeel
volontair
volwassene
von Braun	m
vondeling
voogd
voogdes	f
voorbijganger
voordeurdeler
voorganger
voorgeslacht
voorlichter
voorman	m
voorstander
voorstemmer
voorstopper
voortrekker
voorvechter
voorzitter
vormgever
vormingswerker
vorstin	f
voyeur
vrachtrijder
vrachtvaarder
vragensteller
vrager
vreemde
vreemdeling
vreetzak
vrek
vriend	m
vriendenkring	m
vriendin	f
vrijbuiter
vrijdag	m
vrijdenker
vrijer	m
vrijgezel
vrijmetselaar	m
vrijster	f
vrijwilliger
vrouw	f
vrouwe	f
vrouwmens	f
vrouwtje	f
vuilak
vulkanist
vutter
vuurtorenwachter
vuurvreter
waaghals
waanzinnige
waard
waardigheidsbekleder
waardin	f
waarneemster	f
waarnemer
waarzegger
waarzegster	f
wacht
wachter
waker
wallingant
walvisjager
walvisvaarder
wanbetaler
wandelaar
wangedrocht
warhoofd
wasser
watergeus
watje
wederdoper
wederhelft
weduwe	f
weduwnaar	m
weerman	m
weerwolf
weetal
wegbereider
wegenwachter
weger
wegpiraat
wegwerker
weifelaar
weigeryup	m
weldoener
weldoenster	f
welzijnswerker
werkende
werker
werkgeefster	f
werkgever
werkkracht
werkloze
werkman	m
werknemer
werkster	f
werktuigkundige
werkwillige
werkzoekende
werper
westerling
wetenschapper
wetenschapsman	m
wethouder
wever
wichelaar
wichelaarster	f
wichelares	f
wicht	f
wiegekind
wiegenkind
wielerploeg
wielrenner
wielrijder
wielrijdster	f
wijf	f
wijsgeer
wijsneus
wilde
wildebras
wildschut
wildvreemde
windbuil
windsurfer
winkelier
winkelierster	f
winnaar
winner
wiskundige
wisselagent
wisselwachter
witkiel
woekeraar
woelwater
woesteling
woningzoekende
woordvoerder
workaholic
worstelaar
wraakengel
wreedaard	m
wreker
xantippe	f
xylofonist
yankee
yogi
yup
yuppie
zaakgelastigde
zaakvoerder
zakenman	m
zakenrelatie
zakenvrouw	f
zakkenroller
zakkenwasser	m
zanger
zangeres	f
zatlap
zeebonk	m
zeeman	m
zeerob	m
zeerover
zegelbewaarder
zegsman	m
zegsvrouw	f
zeikstraal
zelfstandige
zemelaar
zendamateur
zendeling
zenuwlijder
zenuwlijer
zenuwpees
zeur
zeurkous
zeurpiet
zever
zeveraar
zieke
zielenknijper
zielenpiet
zielsverwant
ziener
zigeuner
zigeunerin	f
zij	f
zilversmid
zionist
zittenblijver
zoeaaf	m
zoeker
zoetekauw
zondaar
zondag	m
zondagskind
zondagsrijder
zondebok
zonderling
zonneklopper
zoon	m
zoonlief	m
zorgenkind
zuigeling
zuiplap
zuipschuit
zus	f
zuster	f
zuurpruim
zwager	m
zwakkeling
zwamneus
zwarte
zwartepiet
zwartkijker
zwartrok	m
zwartwerker
zweefparachutist
zwemleraar
zwemster	f
zwendelaar
zwerfkind
zwerver
zwijger
«Dominique	m
«Patrick	m
«Tom	m
Árpád	m
Çetin	m
Çöktin	m
Élodie	f
Émile	m
Énée	m
Étienne	m
Öcalan	m
Ömer	m
Önder	m
Örjan	m
Özkan	m
Ünal	m
